愛園愛美	🌈愛園愛美
相羽ういは	🌈相羽ういは
赤羽葉子	🌈赤羽葉子
朝日南アカネ	🌈朝日南アカネ
飛鳥ひな	🌈飛鳥ひな
遠北千南	🌈遠北千南
安土桃	🌈安土桃
天宮こころ	🌈天宮こころ
雨森小夜	🌈雨森小夜
アルス・アルマル	🌈アルス・アルマル
アンジュ・カトリーナ	🌈アンジュ・カトリーナ
家長むぎ	🌈家長むぎ
出雲霞	🌈出雲霞
戌亥とこ	🌈戌亥とこ
イブラヒム	🌈イブラヒム
宇志海いちご	🌈宇志海いちご
卯月コウ	🌈卯月コウ
エクス・アルビオ	🌈エクス・アルビオ
えま★おうがすと	🌈えま★おうがすと
エリー・コニファー	🌈エリー・コニファー
エルフのえる	🌈エルフのえる
御伽原江良	🌈御伽原江良
小野町春香	🌈小野町春香
甲斐田晴	🌈甲斐田晴
加賀美ハヤト	🌈加賀美ハヤト
語部紡	🌈語部紡
叶	🌈叶
神田笑一	🌈神田笑一
北小路ヒスイ	🌈北小路ヒスイ
金魚坂めいろ	🌈金魚坂めいろ
ギルザレンⅢ世	🌈ギルザレンⅢ世
葛葉	🌈葛葉
久遠千歳	🌈久遠千歳
来栖夏芽	🌈来栖夏芽
黒井しば	🌈黒井しば
グウェル・オス・ガール	🌈グウェル・オス・ガール
郡道美玲	🌈郡道美玲
剣持刀也	🌈剣持刀也
弦月藤士郎	🌈弦月藤士郎
三枝明那	🌈三枝明那
桜凛月	🌈桜凛月
笹木咲	🌈笹木咲
椎名唯華	🌈椎名唯華
シェリン・バーガンディ	🌈シェリン・バーガンディ
シスター・クレア	🌈シスター・クレア
静凛	🌈静凛
渋谷ハジメ	🌈渋谷ハジメ
白雪巴	🌈白雪巴
ジョー・力一	🌈ジョー・力一
周央サンゴ	🌈周央サンゴ
健屋花那	🌈健屋花那
鈴鹿詩子	🌈鈴鹿詩子
鈴木勝	🌈鈴木勝
鈴原るる	🌈鈴原るる
鈴谷アキ	🌈鈴谷アキ
雪汝	🌈雪汝
瀬戸美夜子	🌈瀬戸美夜子
鷹宮リオン	🌈鷹宮リオン
月ノ美兎	🌈月ノ美兎
月見しずく	🌈月見しずく
でびでび・でびる	🌈でびでび・でびる
東堂コハク	🌈東堂コハク
轟京子	🌈轟京子
ドーラ	🌈ドーラ
名伽尾アズマ	🌈名伽尾アズマ
長尾景	🌈長尾景
奈羅花	🌈奈羅花
成瀬鳴	🌈成瀬鳴
鳴門こがね	🌈鳴門こがね
西園チグサ	🌈西園チグサ
にじさんじ	🌈にじさんじ
ニュイ・ソシエール	🌈ニュイ・ソシエール
葉加瀬冬雪	🌈葉加瀬冬雪
八朔ゆず	🌈八朔ゆず
花畑チャイカ	🌈花畑チャイカ
早瀬走	🌈早瀬走
葉山舞鈴	🌈葉山舞鈴
春崎エアル	🌈春崎エアル
樋口楓	🌈樋口楓
伏見ガク	🌈伏見ガク
フミ	🌈フミ
文野環	🌈文野環
フレン・E・ルスタリオ	🌈フレン・E・ルスタリオ
不破湊	🌈不破湊
ベルモンド・バンデラス	🌈ベルモンド・バンデラス
星川サラ	🌈星川サラ
空星きらめ	🌈空星きらめ
🌈星空きらめ	🌈空星きらめ
本間ひまわり	🌈本間ひまわり
舞元啓介	🌈舞元啓介
魔界ノりりむ	🌈魔界ノりりむ
ましろ	🌈ましろ
町田ちま	🌈町田ちま
魔使マオ	🌈魔使マオ
黛灰	🌈黛灰
メリッサ・キンレンカ	🌈メリッサ・キンレンカ
モイラ	🌈モイラ
物述有栖	🌈物述有栖
森中花咲	🌈森中花咲
矢車りね	🌈矢車りね
海夜叉神	🌈海夜叉神
社築	🌈社築
山神カルタ	🌈山神カルタ
闇夜乃モルル	🌈闇夜乃モルル
勇気ちひろ	🌈勇気ちひろ
夕陽リリ	🌈夕陽リリ
雪城眞尋	🌈雪城眞尋
夢月ロア	🌈夢月ロア
夢追翔	🌈夢追翔
Yuya Shin	🌈Yuya Shin
ユードリック	🌈ユードリック
夜見れな	🌈夜見れな
ラトナ・プティ	🌈ラトナ・プティ
リゼ・ヘルエスタ	🌈リゼ・ヘルエスタ
緑仙	🌈緑仙
竜胆尊	🌈竜胆尊
ルイス・キャミー	🌈ルイス・キャミー
レヴィ・エリファ	🌈レヴィ・エリファ
童田明治	🌈童田明治
Virtual YouTuber	バーチャルYouTuber
政治	歴史・政治
歴史	歴史・政治
アクセル・ワールド	🎥アクセル・ワールド
異世界食堂	🎥異世界食堂
エスパー魔美	🎥エスパー魔美
がっこうぐらし！	🎥がっこうぐらし！
GATE	🎥GATE
ケムリクサ	🎥ケムリクサ
GATE	🎥GATE
この素晴らしい世界に祝福を	🎥この素晴らしい世界に祝福を
小林さんちのメイドラゴン	🎥小林さんちのメイドラゴン
新世界より	🎥新世界より
城下町のダンデライオン	🎥城下町のダンデライオン
涼宮ハルヒの憂鬱	🎥涼宮ハルヒの憂鬱
絶園のテンペスト	🎥絶園のテンペスト
ソードアート・オンライン	🎥ソードアート・オンライン
盾の勇者の成り上がり	🎥盾の勇者の成り上がり
転生したらスライムだった件	🎥転生したらスライムだった件
亜人ちゃんは語りたい	🎥亜人ちゃんは語りたい
ヘヴィーオブジェクト	🎥ヘヴィーオブジェクト
鬼灯の冷徹	🎥鬼灯の冷徹
ぼくらの	🎥ぼくらの
魔法少女育成計画	🎥魔法少女育成計画
メイドインアビス	🎥メイドインアビス
モーレツ宇宙海賊	🎥モーレツ宇宙海賊
幼女戦記	🎥幼女戦記
落第騎士の英雄譚	🎥落第騎士の英雄譚
Re：ゼロから始める異世界生活	🎥Re：ゼロから始める異世界生活
ログ・ホライズン	🎥ログ・ホライズン
六花の勇者	🎥六花の勇者
ロミオの青い空	🎥ロミオの青い空
STEINS;GATE	🎥STEINS;GATE
慎重勇者～この勇者が俺TUEEEくせに慎重すぎる～	🎥慎重勇者～この勇者が俺TUEEEくせに慎重すぎる～
社会論	文化論・社会論
🌈しば	🌈黒井しば
にじさんじ	🌈にじさんじ
ぷちさんじ	🌈ぷちさんじ
食べ物・飲み物	🍙食べ物・飲み物
コーヒー	☕コーヒー
単語記事	🍀単語記事
🎤Rythem	🎤RYTHEM
🎤歌動画	🎧歌動画
🍚食べ物・飲み物	🍙食べ物・飲み物
投稿まとめ	📋投稿まとめ
➕投稿まとめ	📋投稿まとめ
IT教育	🎓IT教育
ソフトウェア工学	🎓ソフトウェア工学
国際経済法	🎓国際経済法
文化論・社会論	🎓文化論・社会論
歴史・政治	🎓歴史・政治
簿記	🎓簿記
美術	🎓美術
英語学習	🎓英語学習
経済学	🎓経済学
言語学	🎓言語学