Ayumi Hamasaki	浜崎あゆみ
Ai Otsuka	大塚愛
AYAKO IKEDA	池田綾子
Azumi Inoue	井上あずみ
CHAGE and ASKA	CHAGE & ASKA
Doubutsubiscuits	どうぶつビスケッツ
fhana	fhána
itomasumi	伊藤真澄
Kazuyoshi Saito	斉藤和義
Kimiyoshi Akiyama	秋山公良
Kishida Kyodan & The Akeboshi Rockets	岸田教団&THE明星ロケッツ
Kiyono Yasuno	安野希世乃
Kyary Pamyu Pamyu	きゃりーぱみゅぱみゅ
Mai K	Mai-K
Mai K_	Mai-K
Mai Kuraki	倉木麻衣
mewhan	みゆはん
Mikako Komatsu	小松未可子
Miyuki Nakajima	中島みゆき
Momoiro Clover Z	ももいろクローバーZ
Namie Amuro	安室奈美恵
Nana Mizuki	水樹奈々
Nobuo Uematsu	植松伸夫
Oishi Masayoshi	オーイシマサヨシ
ｒｕｍａｎｉａ　ｍｏｎｔｅｖｉｄｅｏ	rumania montevideo
Rina Aiuchi	愛内里菜
Onsoku Line	音速ライン
Rimi Natsukawa	夏川りみ
Shiena Nishizawa	西沢幸奏
Spitz	スピッツ
Takako Matsu	松たか子
Tambourines	the★tambourines
Taro Hakase	葉加瀬太郎
Taro Urashima	浦島太郎
Tetsuro Oda	織田哲郎
Tetsuya Takeda	武田鉄矢
TSUKINOMITO	月ノ美兎
V.A_	Various Artists
Yoshiharu Kawai	川井善晴
YUIKAORI	ゆいかおり
The Countdown Kids	カウントダウン・キッズ
ポケットビスケッツ	ポケット・ビスケッツ
Unknown Artist	Unknown
コンピレーション	Compilations








