! にじさんじ
! --------------------------------------------------------------------------------
あいぞのまなみ	Manami Aizono
あいばういは	Uiha Aiba
あかばねようこ	Youko Akabane
あさひなあかね	Akane Asahina
あすかひな	Hina Asuka
あづちもも	Momo Azuchi
あまみやこころ	Kokoro Amamiya
あめもりさよ	Sayo Amemori
あるすあるまる	Ars Almal
あんじゅかとりーな	Ange Katrina
いえながむぎMugi Ienaga
いずもかすみ	Kasumi Izumo
いぬいとこ	oko Inui
いぶらひむ	Ibrahim
うしみいちご	Ichigo Ushimi
うづきこう	Kou Uzuki
えくすあるびお	Ex Albio
えまおうがすと	Emma August
えりーこにふぁー	Eli Conifer
える	Elu
おとぎばらえら	Era Otogibara
おのまちはるか	Haruka Onomachi
かいだはる	Haru Kaida
かがみはやと	Hayato Kagami
かたりべつむぐ	Tsumugu Kataribe
かなえ	Kanae
かんだしょういち	Shoichi Kanda
きたこうじひすいHisui Kitakoji
きんぎょざかめいろ	Meiro Kingyozaka
ぎるざれんさんせい	Gilzaren Ⅲ
くずは	Kuzuha
くるすなつめ	Natsume Kurusu
くろいしば	Shiba Kuroi
ぐうぇるおすがーる	Gwelu Os Gar
ぐんどうみれい	Mirei Gundo
けんもちとうや	Toya Kenmochi
げんづきとうじろう	Tojiro Genzuki
さえぐさあきな	Akina Saegusa
さくらりつき	Ritsuki Sakura
ささきさく	Saku Sasaki
しいなゆいか	Yuika Shiina
しぇりんばーがんでぃ	Shellin Burgundy
しすたーくれあ	Sister Claire
しずかりん	Rin Shizuka
しぶやはじめ	Hajime Shibuya
しらゆきともえ	Tomoe Shirayuki
じょーりきいち	Joe Rikiichi
すおうさんご	Sango Suo
すこやかな	Kana Sukoya
すずかうたこ	Utako Suzuka
すずきまさる	Masaru Suzuki
すずはらるる	Lulu Suzuhara
すずやあき	Aki Suzuya
せとみやこ	Miyako Seto
そらほしきらめ	Kirame Sorahoshi
たかみやりおん	Rion Takamiya
つきのみと	Mito Tsukino
でびでびでびる	Debidebi Debiru
とうどうこはく	Kohaku Todo
とどろききょうこ	Kyoko Todoroki
どーら	Dola
ながおけい	Kei Nagao
ならか	Naraka
なるせなる	Naru Naruse
にしぞのちぐさ	Chigusa Nishizono
にゅいそしえーる	Nui Sociere
はかせふゆき	Fuyuki Hakase
はなばたけちゃいか	Chaika Hanabatake
はやせそう	Sou Hayase
はやままりん	Marin Hayama
はるさきえある	Air Harusaki
ひぐちかえで	Kaede Higuchi
ふしみがく	Gaku Fushimi
ふみ	Fumi
ふみのたまき	Tamaki Fumino
ふれんいーるすたりお	Furen E Lustario
ふわみなと	Minato Fuwa
べるもんどばんでらす	Belmond Banderas
ほしかわさら	Sara Hoshikawa
ほんまひまわり	Himawari Honma
まいもとけいすけ	Keisuke Maimoto
まかいのりりむMakaino Ririmu
ましろ	Mashiro
まちたちま	Chima Machita
まつかいまお	Mao Matsukai
まゆずみかい	Kai Mayuzumi
めりっさきんれんか	Melissa Kinrenka
もいら	Moira
もののべありす	Alice Mononobe
もりなかかざき	Kazaki Morinaka
やぐるまりね	Rine Yaguruma
やしろきずく	Kizuku Yashiro
やまがみかるた	Karuta Yamagami
ゆうきちひろ	Chihiro Yuki
ゆうひりり	Riri Yuhi
ゆきしろまひろ	Mahiro Yukishiro
ゆづきろあ	Roa Yuzuki
ゆめおいかける	Kakeru Yumeoi
よるみれな	Rena Yorumi
らとなぷてぃ	Ratna Petit
りぜへるえすた	Lize Helesta
りゅーしぇん	Ryushen
りんどうみこと	Mikoto Rindou
るいすきゃみー	Luis Cammy
れゔぃえりふぁ	Levi Elipha
わらべだめいじー	Meiji Warabeda

!	にじさんじ (脱退)
! --------------------------------------------------------------------------------
てんかいつかさ	
ふぇありす	
かみなりぽあろ	
くろははねと	

! にじさんじ (引退)
! --------------------------------------------------------------------------------
あちきたちなみ	
うみやしゃのかみ	
くどうちとせ	
せつな	
つきみしずく	
なかおあずま	
なるとこがね	
はっさくゆず	
やみよのもるる	

! 契約解除
! --------------------------------------------------------------------------------
しんどうらいと	

! 未デビュー
! --------------------------------------------------------------------------------
! ゆーどりっく	
! ゔぉるふがんぐごせい	
! ぷろふぇっさーえばんす	
! さいるすと	
! にこ	
! たかなしみみ	
! うみほしすてら	

! 別名義
! --------------------------------------------------------------------------------
! はなぶせしほ	
! かどなしえりふぁ	
! つきのみう	
! そらぼしきらと	
! るこ	
! よみなみさくや	
! でびっち	
! しぶやおわり	
! のらねこ	

! NIJISANJI ID
! --------------------------------------------------------------------------------
たからでぃまん	Taka Radjiman
ぜあこるねりあ	ZEA Cornelia
はなまきあ	Hana Macchia
らいがりれい	Rai Galilei
あみしあみしぇら	Amicia Michella
みゆおったゔぃあ	Miyu Ottavia
りくさでぃれんどら	Riksa Dhirendra
らいらあるすとろめりあ	Layla Alstroemeria
ならはらまうん	Nara Haramaung
あずらせしりあ	Azura Cecillia
えとな・くりむそん	Etna Crimsona
ぼんにふぃえるぷらなじゃ	Bonnivier Pranaja
しすかれおんたいん	Siska Leontyne

! NIJISANJI KR
! --------------------------------------------------------------------------------
みんすぅーは	Suha Min
しんゆや	Yuya Shin
うぃふぃ	Wiffy
はんちほ	Chiho Han
がおん	Gaon
ちぇあら	Ara Chae
そなぎ	Nagi So
いしう	Siu Lee
あきられい	Ray Akira
いろは	Roha Lee
ぬんぼら	Nun	Bora 

! VirtuaReal Project
! --------------------------------------------------------------------------------
あいね	Eine
るき	Ruki
ななみ	Nanami
いちご	Ichigo
こういち	Kouichi
むり	Muri
ぷらす	Plus
わくひめ	Wakuhime
にゃつき	Nyatsuki
みき	Miki
ほしみ	Hoshimi
まひる	Mahiru
あざ	Aza
やぎみちゆき	Michiyuki Yagi
たびびと	Tabibito
ろい	Roi
せいや	Seiya
さや	Saya
ゆきえ	Yukie
さまえる	Samael
かる	Karu
しき	Shiki
ぱっくす	Pax
かおす	Chaos
きよら	Kiyora
ちはる	Chiharu

! 元 VirtuaReal Project
! --------------------------------------------------------------------------------
はのん	Hano
みもい	Mimoi
ぱっくす	Pax

! NIJISANJI EN
! --------------------------------------------------------------------------------
あでぃあ	Aadya
びはん	Vihaan
ぬーる	Noor

! ユメノグラフィア
! --------------------------------------------------------------------------------
あおみかやな	蒼海カヤナ	人名
あさぎりいづる	朝霧いづる	人名
いちのもりこひな	苺ノ森こひな	人名
かたくらひとみ	片倉一実	人名
くれまはくぼ	暮間珀暮	人名
くれやぺい	紅夜ぺい	人名
こはなてくと	小花てくと	人名
ころぼしまう	ころぼしまう	人名
しのみやとうか	四ノ宮透華	人名
はえとりかづら	蝿取かづら	人名
はとおかここ	鳩岡小恋	人名
ひじりぐれいる	聖グレイル	人名
ひめるち	雛芽るち	人名
ふでそめしき	筆染四季	人名
ほうしょうてあ	宝生てあ	人名
みかげみゆ	観影みゆ	人名
みさごゆきまち	雎雪待	人名
みなみあやね	南絢音	人名
みーてぃあ	ミーティア	人名
りいか	りいか	人名
りくどうかろ	六道カロ	人名
ろっどくろうりー	ロッド・クロウリー	人名