! にじさんじ
! --------------------------------------------------------------------------------
あいぞのまなみ	愛園愛美 (Aizono Manami)
あいばういは	相羽ういは (Aiba Uiha)
あかばねようこ	赤羽葉子 (Akabane Youko)
あさひなあかね	朝日南アカネ (Asahina Akane)
あすかひな	飛鳥ひな (Asuka Hina )
あづちもも	安土桃 (Azuchi Momo)
あまみやこころ	天宮こころ (Amamiya Kokoro)
あめもりさよ	雨森小夜 (Amemori Sayo)
あるすあるまる	アルス・アルマル (Ars Almal)
あんじゅかとりーな	アンジュ・カトリーナ (Ange Katrina)
いえながむぎ	家長むぎ (Ienaga Mugi)
いずもかすみ	出雲霞 (Izumo Kasumi)
いぬいとこ	戌亥とこ (Inui Toko)
いぶらひむ	イブラヒム (Ibrahim)
うしみいちご	宇志海いちご (Ushimi Ichigo)
うづきこう	卯月コウ (Uzuki Kou)
えくすあるびお	エクス・アルビオ (Ex Albio)
えまおうがすと	えま★おうがすと (Emma★August)
えりーこにふぁー	エリー・コニファー (Eli Conifer)
える	える (Elu)
おとぎばらえら	御伽原江良 (Otogibara Era)
おのまちはるか	小野町春香 (Onomachi Haruka)
かいだはる	甲斐田晴 (Kaida Haru)
かがみはやと	加賀美ハヤト (Kagami Hayato)
かたりべつむぐ	語部紡 (Kataribe Tsumugu)
かなえ	叶 (Kanae)
かんだしょういち	神田笑一 (Kanda Shoichi)
きたこうじひすい	北小路ヒスイ (Kitakoji Hisui)
きんぎょざかめいろ	金魚坂めいろ (Kingyozaka Meiro)
ぎるざれんさんせい	ギルザレンⅢ世 (Gilzaren Ⅲ)
くずは	葛葉 (Kuzuha)
くるすなつめ	来栖夏芽 (Kurusu Natsume)
くろいしば	黒井しば (Kuroi Shiba)
ぐうぇるおすがーる	グウェル・オス・ガール (Gwelu Os Gar)
ぐんどうみれい	郡道美玲 (Gundo Mirei)
けんもちとうや	剣持刀也 (Kenmochi Toya)
げんづきとうじろう	弦月藤士郎 (Genzuki Tojiro)
さえぐさあきな	三枝明那 (さえぐさ あきな / Saegusa Akina)
さくらりつき	桜凛月 (さくら りつき / Sakura Ritsuki)
ささきさく	笹木咲 (ささき さく / Sasaki Saku)
しいなゆいか	椎名唯華 (しいな ゆいか / Shiina Yuika)
しぇりんばーがんでぃ	シェリン・バーガンディ (Shellin Burgundy)
しすたーくれあ	シスター・クレア (Sister Claire)
しずかりん	静凛 (しずか りん / Shizuka Rin)
しぶやはじめ	渋谷ハジメ (しぶや はじめ / Shibuya Hajime)
しらゆきともえ	白雪巴 (しらゆき ともえ / Shirayuki Tomoe)
じょーりきいち	ジョー・力一 (― りきいち / Joe Rikiichi)
すおうさんご	周央サンゴ (すおう ― / Suo Sango)
すこやかな	健屋花那 (すこや かな / Sukoya Kana)
すずかうたこ	鈴鹿詩子 (すずか うたこ / Suzuka Utako)
すずきまさる	鈴木勝 (すずき まさる / Suzuki Masaru)
すずはらるる	鈴原るる (すずはら ― / Suzuhara Lulu)
すずやあき	鈴谷アキ (すずや ― / Suzuya Aki)
せとみやこ	瀬戸美夜子 (せと みやこ / Seto Miyako)
そらほしきらめ	空星きらめ (そらほし ― / Sorahoshi Kirame)
たかみやりおん	鷹宮リオン (たかみや ― / Takamiya Rion)
つきのみと	月ノ美兎 (つきの みと / Tsukino Mito)
でびでびでびる	でびでび・でびる (Debidebi Debiru)
とうどうこはく	東堂コハク (とうどう ― / Todo Kohaku)
とどろききょうこ	轟京子 (とどろき きょうこ / Todoroki Kyoko)
どーら	ドーラ(Dola)
ながおけい	長尾景(ながお けい / Nagao Kei)
ならか	奈羅花(Naraka)
なるせなる	成瀬鳴(Naruse Naru)
にしぞのちぐさ	西園チグサ(Nishizono Chigusa)
にゅいそしえーる	ニュイ・ソシエール(Nui Sociere)
はかせふゆき	葉加瀬冬雪(Hakase Fuyuki)
はなばたけちゃいか	花畑チャイカ(Hanabatake Chaika)
はやせそう	早瀬走(Hayase Sou)
はやままりん	葉山舞鈴(Hayama Marin)
はるさきえある	春崎エアル()
ひぐちかえで	樋口楓()
ふしみがく	伏見ガク()
ふみ	フミ()
ふみのたまき	文野環()
ふれんいーるすたりお	フレン・E・ルスタリオ()
ふわみなと	不破湊()
べるもんどばんでらす	ベルモンド・バンデラス()
ほしかわさら	星川サラ()
ほんまひまわり	本間ひまわり()
まいもとけいすけ	舞元啓介()
まかいのりりむ	魔界ノりりむ()
ましろ	ましろ()
まちたちま	町田ちま()
まつかいまお	魔使マオ()
まゆずみかい	黛灰()
めりっさきんれんか	メリッサ・キンレンカ()
もいら	モイラ()
もののべありす	物述有栖()
もりなかかざき	森中花咲()
やぐるまりね	矢車りね()
やしろきずく	社築(Yashiro Kizuku)
やまがみかるた	山神カルタ(Yamagami Karuta)
ゆうきちひろ	勇気ちひろ(Yuki Chihiro)
ゆうひりり	夕陽リリ(Yuhi Riri)
ゆきしろまひろ	雪城眞尋(Yukishiro Mahiro)
ゆづきろあ	夢月ロア(Yuzuki Roa)
ゆめおいかける	夢追翔(Yumeoi Kakeru)
よるみれな	夜見れな(Yorumi Rena)
らとなぷてぃ	ラトナ・プティ(Ratna Petit)
りぜへるえすた	リゼ・ヘルエスタ(Lize Helesta)
りゅーしぇん	緑仙(Ryushen)
りんどうみこと	竜胆尊(Rindou Mikoto)
るいすきゃみー	ルイス・キャミー(Luis Cammy)
れゔぃえりふぁ	レヴィ・エリファ(Levi Elipha)
わらべだめいじー	童田明治(Warabeda Meiji)

!	にじさんじ (脱退)
! --------------------------------------------------------------------------------
てんかいつかさ	天開司 (Tenkai Tukasa)
ふぇありす	ふぇありす (Fairys chan)
かみなりぽあろ	神成ポアロ (Kaminari Poaro)
くろはくろと	黒羽黒兎 (Kuroha Haneto)

! にじさんじ (引退)
! --------------------------------------------------------------------------------
あちきたちなみ	遠北千南
うみやしゃのかみ	海夜叉神
くどうちとせ	久遠千歳
せつな	雪汝
つきみしずく	月見しずく
なかおあずま	名伽尾アズマ
なるとこがね	鳴門こがね
はっさくゆず	八朔ゆず
やみよのもるる	闇夜乃モルル

! 契約解除
! --------------------------------------------------------------------------------
しんどうらいと	真堂雷斗

! 未デビュー
! --------------------------------------------------------------------------------
ゆーどりっく	ユードリック
かさはらあお	笠原蒼
ゔぉるふがんぐごせい	ヴォルフガング5世
ぷろふぇっさーえばんす	プロフェッサー・エバンス
さいるすと	サイルスト
にこ	弐伍
たかなしみみ	小鳥遊ミミ
うみほしすてら	海星ステラ

! 別名義など
! --------------------------------------------------------------------------------
はなぶせしほ	花伏しほ (Hanabuse Shiho)
かどなしえりふぁ	Kadonashi Elifa	// レヴィ・エリファ
つきのみう	月野美兎	//氷儚かの
そらほしきらと	空星キラト (Sorahoshi Kirato)	//星空きらめ
るこ	Ruco	//鈴木勝
よみなみさくや	黄泉波咲夜	//海夜叉神
でびっち	でびっち	//でびでび・でびる
しぶやおわり	渋谷 オワリ	//渋谷ハジメ
のらねこ	野良猫(Noraneko)	//文野環
ゆがみん	ゆがみん (Yugamin)
たずみりく	田角リク (Tadumi Riku)
けんもちりきや	剣持力也 (Kenmochi Rikiya)
けんもちとうこ	剣持刀子 (Kenmochi Touko)

! NIJISANJI ID
! --------------------------------------------------------------------------------
たからじまん	Taka Radjiman (タカ・ラジマン)
ぜあこるねりあ	ZEA Cornelia (ゼア・コルネリア)
はなまきあ	Hana Macchia (ハナ・マキア)
らいがりれい	Rai Galilei (ライ・ガリレイ)
あみしあみしぇら	Amicia Michella (アミシア・ミシェラ)
みゆおったゔぃあ	Miyu Ottavia (ミユ・オッタヴィア)
りくさでぃれんどら	Riksa Dhirendra (リクサ・ディレンドラ)
らいらあるすとろえめりあ	Layla Alstroemeria (ライラ・アルストロエメリア)
ならはらまうん	Nara Haramaung (ナラ・ハラマウン)
あずらせしりあ	Azura Cecillia (アズラ・セシリア)
えとなくりむそん	Etna Crimsona (エトナ・クリムソン)
ぼんにふぃえるぷらなじゃ	Bonnivier Pranaja (ボンニフィエル・プラナジャ)
しすかれおんたいん	Siska Leontyne (シスカ・レオンタイン)

! NIJISANJI KR
! --------------------------------------------------------------------------------
あきられい	아키라 레이 (明楽レイ / Ray Akira)
いしう	이시우 (イ・シウ / Siu Lee)
いろは	이로하 (イ・ロハ / Roha Lee)
うぃふぃ	위피 (ウィフィ / Wiffy)
がおん	가온 (ガオン / Gaon)
しんゆや	신유야 (シン・ユヤ / 申幽夜 / Yuya Shin)
そなぎ	소나기 (ソ・ナギ / Nagi So)
ちぇあら	채아라 (チェ・アラ / Ara Chae)
ぬんぼら	눈보라 (ヌン・ボラ / Nun Bora)
はんちほ	한치호 (ハン·チホ / 韓淄蝴 / Chiho Han)
みんすぅーは	민수하 (ミン・スゥーハ / Suha Min)

! NIJISANJI KR (引退・脱退)
! --------------------------------------------------------------------------------
ゆるり	유루리 (ユ・ルリ / Yu Ruri)
かえん	카엔 (カエン / Kaen)
ろーろー	로로 (ローロー / Lorou)
はくれん	백연 (ハクレン / 白恋 / Hakuren)

! VirtuaReal Project
! --------------------------------------------------------------------------------
あいね	艾因 ( Eine)
あざ	阿萨 (Aza)
いちご	一果 (Ichigo)
かおす	卡欧斯 (Chaos)
かる	花留 (Karu)
きよら	清良 (Kiyora)
こういち	光一 (Kouichi)
さまえる	萨麦尔 (Samael)
さや	沙夜 (Saya)
しき	紫纪 (Shiki)
せいや	星也 (Seiya)
たびびと	度人 (Tabibito)
ちはる	千春 (Chiharu)
ななみ	七海 ( Nanami)
にゃつき	喵月 (Nyatsuki)
ぷらす	有加 (Plus)
ほしみ	星弥 (Hoshimi)
まひる	真绯瑠 (Mahiru)
みき	弥希 (Miki)
むり	无理 (Muri)
やぎみちゆき	八木迪之 (Yagi)
ゆきえ	雪絵 (Yukie)
るき	琉绮 (Ruki)
ろい	罗伊 (Roi)
わくひめ	惑姫 (Waku)

! VirtuaReal Star
! --------------------------------------------------------------------------------
りんいぇんようさ	泠鸢Yousa (Ling Yuan Yousa)

! 元 VirtuaReal Project
! --------------------------------------------------------------------------------
はのん	羽音 (ハノン / Hanon)
みもい	御水 (ミモイ / Mimoi)
ぱっくす	帕克丝 (パックス / Pax)

! NIJISANJI EN
! --------------------------------------------------------------------------------
あでぃあ	Aadya (アディア)
びはん	Vihaan (ビハン)
ぬーる	Noor (ヌール)

! ユメノグラフィア
! --------------------------------------------------------------------------------
あおみかやな	蒼海カヤナ (Aomi Kayana)
あさぎりいづる	朝霧いづる (Asagiri Izuru)
いちのもりこひな	苺ノ森こひな (Ichinomori Kohina)
かたくらひとみ	片倉一実 (Katakura Hitomi)
くれまはくぼ	暮間珀暮 (Kurema Hakubo)
くれやぺい	紅夜ぺい (Kureya Pei)
こはなてくと	小花てくと (Kohana Techt)
ころぼしまう	ころぼしまう (Koroboshi Mau)
しのみやとうか	四ノ宮透華 (Shinomiya Touca)
はえとりかづら	蝿取かづら (Haetori Kazura)
はとおかここ	鳩岡小恋 (Hatohka Coco)
ひじりぐれいる	聖グレイル (Hijiri Grail)
ひめるち	雛芽るち (Hime Ruchi)
ふでそめしき	筆染四季 (Fudesome Shiki)
ほうしょうてあ	宝生てあ (Hosho Tea)
みかげみゆ	観影みゆ (Mikage Miyu)
みさごゆきまち	雎雪待 (Misago Yukimachi)
みなみあやね	南絢音 (Minami Ayane)
みーてぃあ	ミーティア (Meteor)
りいか	りいか (Reeka)
りくどうかろ	六道カロ (Rikudou Karo)
ろっどくろうりー	ロッド・クロウリー (Rod Crowley)

! SLEE
! --------------------------------------------------------------------------------
ももはらみのり	ももはらみのり (Momohara Minori)
ひくらかの	氷儚かの (Hikura Kano)
ひめなぎさ	姫なぎさ (Hime Nagisa)
あかづえまりん	赤杖まりん (Akadzue Marine)