! にじさんじ
! --------------------------------------------------------------------------------
あいぞのまなみ	愛園 愛美
あいばういは	相羽 ういは
あかばねようこ	赤羽 葉子
あさひなあかね	朝日南 アカネ
あすかひな	飛鳥 ひな
あづちもも	安土 桃
あまみやこころ	天宮 こころ
あめもりさよ	雨森 小夜
あるすあるまる	アルス・アルマル
あんじゅかとりーな	アンジュ・カトリーナ
いえながむぎ	家長 むぎ
いずもかすみ	出雲 霞
いぬいとこ	戌亥 とこ
いぶらひむ	イブラヒム
うしみいちご	宇志海 いちご
うづきこう	卯月 コウ
えくすあるびお	エクス・アルビオ
えまおうがすと	えま★おうがすと
えりーこにふぁー	エリー・コニファー
える	える
おとぎばらえら	御伽原 江良
おのまちはるか	小野町 春香
かいだはる	甲斐田 晴
かがみはやと	加賀美 ハヤト
かたりべつむぐ	語部 紡
かなえ	叶
かんだしょういち	神田 笑一
きたこうじひすい	北小路 ヒスイ
きんぎょざかめいろ	金魚坂 めいろ
ぎるざれんさんせい	ギルザレン Ⅲ世
くずは	葛葉
くるすなつめ	来栖 夏芽
くろいしば	黒井 しば
ぐうぇるおすがーる	グウェル・オス・ガール
ぐんどうみれい	郡道 美玲
けんもちとうや	剣持 刀也
げんづきとうじろう	弦月 藤士郎
さえぐさあきな	三枝 明那
さくらりつき	桜凛 月
ささきさく	笹木 咲
しいなゆいか	椎名 唯華
しぇりんばーがんでぃ	シェリン・バーガンディ
しすたーくれあ	シスター・クレア
しずかりん	静 凛
しぶやはじめ	渋谷 ハジメ
しらゆきともえ	白雪 巴
じょーりきいち	ジョー・力一
すおうさんご	周央 サンゴ
すこやかな	健屋 花那
すずかうたこ	鈴鹿 詩子
すずきまさる	鈴木 勝
すずはらるる	鈴原 るる
すずやあき	鈴谷 アキ
せとみやこ	瀬戸 美夜子
そらほしきらめ	空星 きらめ
たかみやりおん	鷹宮 リオン
つきのみと	月ノ 美兎
でびでびでびる	でびでび・でびる
とうどうこはく	東堂 コハク
とどろききょうこ	轟 京子
どーら	ドーラ
ながおけい	長尾 景
ならか	奈羅花
なるせなる	成瀬 鳴
にしぞのちぐさ	西園 チグサ
にゅいそしえーる	ニュイ・ソシエール
はかせふゆき	葉加瀬 冬雪
はなばたけちゃいか	花畑 チャイカ
はやせそう	早瀬 走
はやままりん	葉山 舞鈴
はるさきえある	春崎 エアル
ひぐちかえで	樋口 楓
ふしみがく	伏見 ガク
ふみ	フミ
ふみのたまき	文野 環
ふれんいーるすたりお	フレン・E・ルスタリオ
ふわみなと	不破 湊
べるもんどばんでらす	ベルモンド・バンデラス
ほしかわさら	星川 サラ
ほんまひまわり	本間 ひまわり
まいもとけいすけ	舞元 啓介
まかいのりりむ	魔界ノ りりむ
ましろ	ましろ
まちたちま	町田 ちま
まつかいまお	魔使 マオ
まゆずみかい	黛 灰
めりっさきんれんか	メリッサ・キンレンカ
もいら	モイラ
もののべありす	物述 有栖
もりなかかざき	森中 花咲
やぐるまりね	矢車 りね
やしろきずく	社 築
やまがみかるた	山神 カルタ
ゆうきちひろ	勇気ち ひろ
ゆうひりり	夕陽 リリ
ゆきしろまひろ	雪城 眞尋
ゆづきろあ	夢月 ロア
ゆめおいかける	夢追 翔
よるみれな	夜見 れな
らとなぷてぃ	ラトナ・プティ
りぜへるえすた	リゼ・ヘルエスタ
りゅーしぇん	緑仙
りんどうみこと	竜胆 尊
るいすきゃみー	ルイス・キャミー
れゔぃえりふぁ	レヴィ・エリファ
わらべだめいじー	童田 明治

!	にじさんじ (脱退)
! --------------------------------------------------------------------------------
てんかいつかさ	天開 司
ふぇありす	ふぇありす
かみなりぽあろ	神成 ポアロ
くろはくろと	黒羽 黒兎

! にじさんじ (引退)
! --------------------------------------------------------------------------------
あちきたちなみ	遠北 千南
うみやしゃのかみ	海夜叉 神
くどうちとせ	久遠 千歳
せつな	雪汝
つきみしずく	月見 しずく
なかおあずま	名伽尾 アズマ
なるとこがね	鳴門 こがね
はっさくゆず	八朔 ゆず
やみよのもるる	闇夜乃 モルル

! 契約解除
! --------------------------------------------------------------------------------
しんどうらいと	真堂 雷斗

! 未デビュー
! --------------------------------------------------------------------------------
ゆーどりっく	ユードリック
ゔぉるふがんぐごせい	ヴォルフガング 5世
ぷろふぇっさーえばんす	プロフェッサー・エバンス
さいるすと	サイルスト
にこ	弐伍
たかなしみみ	小鳥遊 ミミ
うみほしすてら	海星 ステラ

! 別名義など
! --------------------------------------------------------------------------------
はなぶせしほ	花伏 しほ
かどなしえりふぁ	角無 絵里華
つきのみう	月野 美兎
そらほしきらと	空星 キラト
るこ	Ruco
よみなみさくや	黄泉波 咲夜
でびっち	でびっち
しぶやおわり	渋谷 オワリ
のらねこ	野良猫
ゆがみん	ゆがみん
たずみりく	田角 リク
けんもちりきや	剣持 力也
けんもちとうこ	剣持 刀子

! NIJISANJI ID
! --------------------------------------------------------------------------------
たからでぃまん	タカ・ラジマン
ぜあこるねりあ	ゼア・コルネリア
はなまきあ	ハナ・マキア
らいがりれい	ライ・ガリレイ
あみしあみしぇら	アミシア・ミシェラ
みゆおったゔぃあ	ミユ・オッタヴィア
りくさでぃれんどら	リクサ・ディレンドラ
らいらあるすとろめりあ	ライラ・アルストロエメリア
ならはらまうん	ナラ・ハラマウン
あずらせしりあ	アズラ・セシリア
えとなくりむそん	エトナ・クリムソン
ぼんにふぃえるぷらなじゃ	ボンニフィエル・プラナジャ
しすかれおんたいん	シスカ・レオンタイン

! NIJISANJI KR
! --------------------------------------------------------------------------------
みんすぅーは	ミン・スゥーハ
しんゆや	シン・ユヤ
うぃふぃ	ウィフィ
はんちほ	ハン·チホ
がおん	ガオン
ちぇあら	チェ・アラ
そなぎ	ソ・ナギ
いしう	イ・シウ
あきられい	明楽 レイ
いろは	イ・ロハ
ぬんぼら	ヌン・ボラ

! NIJISANJI KR (引退・脱退)
! --------------------------------------------------------------------------------
もありん	モ･アリン
ゆるり	ユ・ルリ
かえん	カエン
ろーろー	ローロー
はくれん	ハクレン

! VirtuaReal Project
! --------------------------------------------------------------------------------
あいね	アイネ
るき	ルキ
ななみ	ナナミ
いちご	イチゴ
こういち	コウイチ
むり	ムリ
ぷらす	プラス
わくひめ	ワクヒメ
にゃつき	ニャツキ
みき	ミキ
ほしみ	ホシミ
まひる	マヒル
あざ	アザ
やぎみちゆき	八木 迪之
たびびと	タビビト
ろい	ロイ
せいや	セイヤ
さや	サヤ
ゆきえ	ユキエ
さまえる	サマエル
かる	カル
しき	シキ
かおす	カオス
きよら	キヨラ
ちはる	若月 千春

! VirtuaReal Star
! --------------------------------------------------------------------------------
りんいぇんようさ	🌈🇨🇳⭐ 泠鸢Yousa

! 元 VirtuaReal Project
! --------------------------------------------------------------------------------
はのん	ハノン
みもい	ミモイ
ぱっくす	パックス

! NIJISANJI EN
! --------------------------------------------------------------------------------
あでぃあ	アディア
びはん	ビハン
ぬーる	ヌール

! ユメノグラフィア
! --------------------------------------------------------------------------------
あおみかやな	蒼海 カヤナ
あさぎりいづる	朝霧 いづる
いちのもりこひな	苺ノ森 こひな
かたくらひとみ	片倉 一実
くれまはくぼ	暮間 珀暮
くれやぺい	紅夜 ぺい
こはなてくと	小花 てくと
ころぼしまう	ころぼし まう
しのみやとうか	四ノ宮 透華
はえとりかづら	蝿取 かづら
はとおかここ	鳩岡 小恋
ひじりぐれいる	聖 グレイル
ひめるち	雛芽 るち
ふでそめしき	筆染 四季
ほうしょうてあ	宝生 てあ
みかげみゆ	観影 みゆ
みさごゆきまち	雎 雪待
みなみあやね	南 絢音
みーてぃあ	ミーティア
りいか	りいか
りくどうかろ	六道 カロ
ろっどくろうりー	ロッド・クロウリー

! SLEE
! --------------------------------------------------------------------------------
ももはらみのり	ももはら みのり
ひくらかの	氷儚 かの
ひめなぎさ	姫 なぎさ
あかづえまりん	赤杖 まりん