! にじさんじ
! --------------------------------------------------------------------------------
あいぞのまなみ	🌈愛園愛美
あいばういは	🌈相羽ういは
あかばねようこ	🌈赤羽葉子
あさひなあかね	🌈朝日南アカネ
あすかひな	🌈飛鳥ひな
あづちもも	🌈安土桃
あまみやこころ	🌈天宮こころ
あめもりさよ	🌈雨森小夜
あるすあるまる	🌈アルス・アルマル
あんじゅかとりーな	🌈アンジュ・カトリーナ
いえながむぎ	🌈家長むぎ
いずもかすみ	🌈出雲霞
いぬいとこ	🌈戌亥とこ
いぶらひむ	🌈イブラヒム
うしみいちご	🌈宇志海いちご
うづきこう	🌈卯月コウ
えくすあるびお	🌈エクス・アルビオ
えまおうがすと	🌈えま★おうがすと
えりーこにふぁー	🌈エリー・コニファー
える	🌈エルフのえる
えるふのえる	🌈エルフのえる
おとぎばらえら	🌈御伽原江良
おのまちはるか	🌈小野町春香
かいだはる	🌈甲斐田晴
かがみはやと	🌈加賀美ハヤト
かたりべつむぐ	🌈語部紡
かなえ	🌈叶
かんだしょういち	🌈神田笑一
きたこうじひすい	🌈北小路ヒスイ
きんぎょざかめいろ	🌈金魚坂めいろ
ぎるざれんさんせい	🌈ギルザレンⅢ世
くずは	🌈葛葉
くるすなつめ	🌈来栖夏芽
くろいしば	🌈黒井しば
ぐうぇるおすがーる	🌈グウェル・オス・ガール
ぐんどうみれい	🌈郡道美玲
けんもちとうや	🌈剣持刀也
げんづきとうじろう	🌈弦月藤士郎
さえぐさあきな	🌈三枝明那
さくらりつき	🌈桜凛月
ささきさく	🌈笹木咲
しいなゆいか	🌈椎名唯華
しぇりんばーがんでぃ	🌈シェリン・バーガンディ
しすたーくれあ	🌈シスター・クレア
しずかりん	🌈静凛
しぶやはじめ	🌈渋谷ハジメ
しらゆきともえ	🌈白雪巴
じょーりきいち	🌈ジョー・力一
すおうさんご	🌈周央サンゴ
すこやかな	🌈健屋花那
すずかうたこ	🌈鈴鹿詩子
すずきまさる	🌈鈴木勝
すずはらるる	🌈鈴原るる
すずやあき	🌈鈴谷アキ
せとみやこ	🌈瀬戸美夜子
たかみやりおん	🌈鷹宮リオン
つきのみと	🌈月ノ美兎
でびでびでびる	🌈でびでび・でびる
とうどうこはく	🌈東堂コハク
とどろききょうこ	🌈轟京子
どーら	🌈ドーラ
ながおけい	🌈長尾景
ならか	🌈奈羅花
なるせなる	🌈成瀬鳴
にしぞのちぐさ	🌈西園チグサ
にゅいそしえーる	🌈ニュイ・ソシエール
はかせふゆき	🌈葉加瀬冬雪
はなばたけちゃいか	🌈花畑チャイカ
はやせそう	🌈早瀬走
はやままりん	🌈葉山舞鈴
はるさきえある	🌈春崎エアル
ひぐちかえで	🌈樋口楓
ふしみがく	🌈伏見ガク
ふみ	🌈フミ
ふみのたまき	🌈文野環
ふれんいーるすたりお	🌈フレン・Ｅ・ルスタリオ
ふわみなと	🌈不破湊
べるもんどばんでらす	🌈ベルモンド・バンデラス
ほしかわさら	🌈星川サラ
そらほしきらめ	🌈空星きらめ
ほんまひまわり	🌈本間ひまわり
まいもとけいすけ	🌈舞元啓介
まかいのりりむ	🌈魔界ノりりむ
ましろ	🌈ましろ
まちたちま	🌈町田ちま
まつかいまお	🌈魔使マオ
まゆずみかい	🌈黛灰
めりっさきんれんか	🌈メリッサ・キンレンカ
もいら	🌈モイラ
もののべありす	🌈物述有栖
もりなかかざき	🌈森中花咲
やぐるまりね	🌈矢車りね
やしろきずく	🌈社築
やまがみかるた	🌈山神カルタ
ゆうきちひろ	🌈勇気ちひろ
ゆうひりり	🌈夕陽リリ
ゆきしろましろ	🌈雪城眞尋
ゆづきろあ	🌈夢月ロア
ゆめおいかける	🌈夢追翔
よるみれな	🌈夜見れな
らとなぷてぃ	🌈ラトナ・プティ
りぜへるえすた	🌈リゼ・ヘルエスタ
りゅーしぇん	🌈緑仙
りんどうみこと	🌈竜胆尊
るいすきゃみー	🌈ルイス・キャミー
れゔぃえりふぁ	🌈レヴィ・エリファ
わらべだめいじー	🌈童田明治

!	にじさんじ (脱退)
! --------------------------------------------------------------------------------
くろはくろと	🌈😥黒羽黒兎
かみなりぽあろ	🌈😥神成ポアロ
てんかいつかさ	👤天開司
ふぇありす	👤ふぇありす

! にじさんじ (引退)
! --------------------------------------------------------------------------------
あちきたちなみ	🌈😥遠北千南
うみやしゃのかみ	🌈😥海夜叉神
くどうちとせ	🌈😥久遠千歳
せつな	🌈😥雪汝
つきみしずく	🌈😥月見しずく
なかおあずま	🌈😥名伽尾アズマ
なるとこがね	🌈😥鳴門こがね
はっさくゆず	🌈😥八朔ゆず
やみよのもるる	🌈😥闇夜乃モルル

! 契約解除
! --------------------------------------------------------------------------------
しんどうらいと	👤真堂雷斗

! 未デビュー
! --------------------------------------------------------------------------------
ゆーどりっく	🌈🌒ユードリック
かさはらあお	🌈🌒笠原蒼
ゔぉるふがんぐごせい	🌈🌒ヴォルフガング5世
ぷろふぇっさーえばんす	🌈🌒Ph.エバンス
さいるすと	🌈🌒サイルスト
にこ	🌈🌒弐伍
たかなしみみ	🌈🌒小鳥遊ミミ
うみほしすてら	🌈🌒海星ステラ

! 別名義・その他
! --------------------------------------------------------------------------------
かどなしえりふぁ	🌈❜ 角無絵里華	// レヴィ・エリファ
けんもちとうこ	🌈❜ 剣持刀子
けんもちりきや	🌈❜ 剣持力也
しぶやおわり	🌈❜ 渋谷オワリ
そらほしきらと	🌈❜ 空星キラト	// 星空きらめ
つきのみう	🌈❜ 月野美兎	// 月ノ美兎
なぞのみと	🌈❜ 謎ノ美兎	// 月ノ美兎
でびっち	🌈❜ でびっち
のらねこ	🌈❜ 野良猫
はなぶせしほ	🌈❜ 花伏しほ	// 黒井しば
ゆがみん	🌈ゆがみん
よみなみさくや	🌈❜ 黄泉波咲夜	// 海夜叉神
ろくめいかんきりこ	🌈❜ 鹿鳴館キリコ
るこ	🌈❜ Ruco	// 鈴木勝

! NIJISANJI ID
! --------------------------------------------------------------------------------
たからじまん	🌈🇮🇩 Taka Radjiman
ぜあこるねりあ	🌈🇮🇩 ZEA Cornelia
はなまきあ	🌈🇮🇩 Hana Macchia
らいがりれい	🌈🇮🇩 Rai Galilei
あみしあみしぇら	🌈🇮🇩 Amicia Michella
みゆおったゔぃあ	🌈🇮🇩 Miyu Ottavia
りくさでぃれんどら	🌈🇮🇩 Riksa Dhirendra
らいらあるすとろえめりあ	🌈🇮🇩 Layla Alstroemeria
ならはらまうん	🌈🇮🇩 Nara Haramaung
あずらせしりあ	🌈🇮🇩 Azura Cecillia
えとなくりむそん	🌈🇮🇩 Etna Crimson
ぼんにふぃえるぷらなじゃ	🌈🇮🇩 Bonnivier Pranaja
しすかれおんたいん	🌈🇮🇩 Siska Leontyne

! NIJISANJI KR
! --------------------------------------------------------------------------------
みんすぅーは	🌈🇰🇷 Min Suha
しんゆや	🌈🇰🇷 Shin Yuya
ゆや	🌈🇰🇷 Shin Yuya
うぃふぃ	🌈🇰🇷 Wiffy
はんちほ	🌈🇰🇷 Han Chiho
ちほ	🌈🇰🇷 Han Chiho
がおん	🌈🇰🇷 Gaon
ちぇあら	🌈🇰🇷 Chae Ara
そなぎ	🌈🇰🇷 So Nagi
なぎ	🌈🇰🇷 So Nagi
いしう	🌈🇰🇷 Lee Siu
あきられい	🌈🇰🇷 Akira Ray
れい	🌈🇰🇷 Akira Ray
いろは	🌈🇰🇷 Lee Roha
ぬんぼら	🌈🇰🇷 Bora Nun
ぼら	🌈🇰🇷 Bora Nun

! NIJISANJI KR (引退・脱退)
! --------------------------------------------------------------------------------
ゆるり	🌈🇨🇳😥 Yu Ruri
かえん	🌈🇨🇳😥 Kaen
ろーろー	🌈🇨🇳😥 Lorou
はくれん	🌈🇨🇳😥 Hakuren

! VirtuaReal Project
! --------------------------------------------------------------------------------
あいね	🌈🇨🇳 艾因(Eine)
るき	🌈🇨🇳 琉绮(Ruki)
ななみ	🌈🇨🇳 七海(Nanami)
いちご	🌈🇨🇳 一果(Ichigo)
こういち	🌈🇨🇳 光一(Kouichi)
むり	🌈🇨🇳 无理(Muri)
ぷらす	🌈🇨🇳 有加(Plus)
わくひめ	🌈🇨🇳 惑姫(Waku)
にゃつき	🌈🇨🇳 喵月(Nyatsuki)
みき	🌈🇨🇳 弥希(Miki)
ほしみ	🌈🇨🇳 星弥(Hoshimi)
まひる	🌈🇨🇳 真绯瑠(Mahiru)
あざ	🌈🇨🇳 阿萨(Aza)
やぎみちゆき	🌈🇨🇳 八木迪之(Yagi)
たびびと	🌈🇨🇳 度人(Tabibito)
ろい	🌈🇨🇳 罗伊(Roi)
せいや	🌈🇨🇳 星也(Seiya)
さや	🌈🇨🇳 沙夜(Saya)
ゆきえ	🌈🇨🇳 雪絵(Yukie)
さまえる	🌈🇨🇳 萨麦尔(Samael)
かる	🌈🇨🇳 花留(Karu)
しき	🌈🇨🇳 紫纪(Shiki)
かおす	🌈🇨🇳 卡欧斯(Chaos)
きよら	🌈🇨🇳 清良(Kiyora)
ちはる	🌈🇨🇳 千春(Chiharu)

! 元 VirtuaReal Project
! --------------------------------------------------------------------------------
はのん	🌈🇨🇳😥 羽音(Hanon)
みもい	🌈🇨🇳😥 御水(Mimoi)
ぱっくす	🌈🇨🇳😥 帕克丝(Pax)

! NIJISANJI EN
! --------------------------------------------------------------------------------
あでぃあ	🌈🇮🇳 Aadya(アディア)
びはん	🌈🇮🇳 Vihaan(ビハン)
ぬーる	🌈🇮🇳 Noor(ヌール)

! ユメノグラフィア
! --------------------------------------------------------------------------------
あおみかやな	💭蒼海カヤナ
あさぎりいづる	💭朝霧いづる
いちのもりこひな	💭苺ノ森こひな
かたくらひとみ	💭片倉一実
くれまはくぼ	💭暮間珀暮
くれやぺい	💭紅夜ぺい
こはなてくと	💭小花てくと
ころぼしまう	💭ころぼしまう
しのみやとうか	💭四ノ宮透華
はえとりかづら	💭蝿取かづら
はとおかここ	💭鳩岡小恋
ひじりぐれいる	💭聖グレイル
ひめるち	💭雛芽るち
ふでそめしき	💭筆染四季
ほうしょうてあ	💭宝生てあ
みかげみゆ	💭観影みゆ
みさごゆきまち	💭雎雪待
みなみあやね	💭南絢音
みーてぃあ	💭ミーティア
りいか	💭りいか
りくどうかろ	💭六道カロ
ろっどくろうりー	💭ロッド・クロウリー

! にじさんじ・コラボ等
! --------------------------------------------------------------------------------

あいおいくろいながおけい	🌈👥あいおいくろいながおけい
あいすぐみ	🌈👥アイス組
あいちーむ	🌈👥Iチーム
あかのそしき	🌈👥赤の組織
あかんご	🌈👥アカンゴ
あくまどーじょー	🌈👥あくまどーじょー
あくむぐみ	🌈👥悪夢組
あしたはれるかな	🌈👥明日晴れる花那
あずゆず	🌈👥アズゆず
あほ	🌈👥aho
あめもりくどう	🌈👥雨森久遠
あらさーらんくたい	🌈👥アラサーランク帯
ありすとろべりー	🌈👥アリストロベリー
ありめいじす	🌈👥ありめいじす
あんでとこ	🌈👥あん・で・とこ
あんまお	🌈👥アンマオ
あーことひすぴ	🌈👥あーことひすぴ
いずもるる	🌈👥いずもるる
いたずらぐみ	🌈👥痛面組
いたづらぐみ	🌈👥痛面組
いちがく	🌈👥いちガク
いちきせいしゅっしん	🌈👥一期生出身
いちひま	🌈👥いちひま
いっきせいしゅっしん	🌈👥一期生出身
いっそういっせい	🌈👥一槍一星
いぬふく	🌈👥犬福
いのこりぐみ	🌈👥いのこり組
いのるぱんだ	🌈👥いのるぱんだ
いんくふぃっしゅ	🌈👥インクフィッシュ
いーりす	🌈👥i's
うぃんぐこらぼ	🌈👥wingこらぼ
ういにんぐらん	🌈👥ういにんぐらん
ういまる	🌈👥ういまる
うさちゃんくらぶうぃずびー	🌈👥うさちゃんクラブwithB
うたかざ	🌈👥うたかざ
うたまさ	🌈👥うたまさ
うたみこ	🌈👥うたみこ
うたみこばねまんじ	🌈👥うたみこバネ卍
うみこんにゃく	🌈👥海こんにゃく
うんちきょう	🌈👥うんち教
うーちー	🌈👥うーちー
えあけい	🌈👥エア景
えくしぶ	🌈👥Exsiv
えくすげまずがーるず	🌈👥EXゲマズガールズ
えくすげーまーず	🌈👥EXゲーマーズ
えくれあ	🌈👥エクレア
えすえすえーおー	🌈👥SSAO
えすえふぐみ	🌈👥SF組
えばーぐりーんなーど	🌈👥evergreen nerd
えびせん	🌈👥エビ仙
えびちり	🌈👥エビチリ
えびまる	🌈👥エビマル
えらーず	🌈👥ERRors
えるえるかにかん	🌈👥LLカニ缶
えるかざがく	🌈👥えるかざガク
えれくとろにっくれいんぼうたくてぃくす	🌈👥Electronic Rainbow Tactics(ERT)
えんじょうりゅうせいぐん	🌈👥炎上流星群
えーてぃーえむ	🌈👥ATM
おきゅうじかるてっと	🌈👥お給仕カルテット
おしぃりぃ	🌈👥おしぃりぃ
おしぃりぃまわり	🌈👥おしぃりぃまわり
おっさんげーむす	🌈👥おっさんゲームス
おとこぐみ	🌈👥漢組
おなえどしぐみ	🌈👥おなえどし組
おののみれい	🌈👥おののみれい
おりこう	🌈👥おりコウ
おりひめぼし	🌈👥織姫星
おんなのいやなところ	🌈👥女の嫌なところ
おーてぃーえぬぐみ	🌈👥OTN組
かいさんぎぐ	🌈👥解散GIG
かえでとみと	🌈👥楓と美兎
かえでりこ	🌈👥カエデリコ
かえる	🌈👥かえる
かがおいはやる	🌈👥加賀追ハヤル
かざがく	🌈👥かざガク
かためかくれず	🌈👥片目隠れズ
かなえよう	🌈👥叶え葉
かなしいくず	🌈👥かなしいくず
かなしいな	🌈👥かなしいな
かなふぇあ	🌈👥かなふぇあ
かなめいじー	🌈👥かなめいじー
かびばばあ	🌈👥カビババア
かるぴす	🌈👥カルピス
がちくずのうか	🌈👥ガチ屑農家
がっかい	🌈👥ガッ灰
がぶりえら	🌈👥がぶりえら
きんぎんどうぽん	🌈👥金銀銅ポン
きんのばかぎんのばか	🌈👥金のバカ銀のバカ
ぎばらいか	🌈👥ギバライカ
くさおしぃりぃ	🌈👥くさおしぃりぃ
くずじんじゃ	🌈👥葛神社
くずばねおしぃりぃ	🌈👥くずばねおしぃりぃ
くずもちとろあ	🌈👥くずもちとろあ
くずんぼ	🌈👥くずンボ
くそげーはんたー	🌈👥クソゲーハンター
くそざこげーみんぐ	🌈👥くそざこGaming
くまいさん	🌈👥くまいさん
くまもっさん	🌈👥くまもっさん
くらげ	🌈👥海月
くれっしぇんど	🌈👥cresc.
くれないのらいへんばっは	🌈👥紅のライヘンバッハ
くれなる	🌈👥くれなる
くろしっく	🌈👥Crossick
くろのひまわり	🌈👥黒ノ火廻
くろのわちー	🌈👥くろのわちー
くろのわーる	🌈👥ChroNoiR
ぐりーんふれんど	🌈👥グリーンフレンド
ぐりーんるーじゅ	🌈👥グリーンルージュ
ぐんかん	🌈👥ぐんかん
ぐんかんふらわーず	🌈👥ぐんかんフラワーズ
げそのきわみおとめ	🌈👥ゲソの極み乙女
げっかのえんま	🌈👥月花ノ焔魔
げっかびじん	🌈👥月華美人
こあくまん	🌈👥こあくまん
こうはくあほがっせん	🌈👥紅白アホ合戦
こうはくまんじゅう	🌈👥紅白饅頭
こくむちょう	🌈👥黒夢町
ここふれわんわん	🌈👥ここフレわんわん
こんとんぐみ	🌈👥混沌組
ごううんじたてえびのゆきどけふれんち	🌈👥豪運仕立て海老の雪どけフレンチ
ござやよ	🌈👥ござやよ
ござる	🌈👥ござる
ござんぼ	🌈👥ござンボ
さいこぐみ	🌈👥サイコ組
さいこぱすぶらざーず	🌈👥サイコパスブラザーズ
さくゆい	🌈👥さくゆい
さくらてんじんぐう	🌈👥桜天神宮
さくらとな	🌈👥サクラトナ
さけかすべいびーず	🌈👥酒かすべいびーず
さんしゃめんだん	🌈👥三者面団
さんばか	🌈👥さんばか
しぃせんぐみ	🌈👥しぃせん組
しいくいんとれっさーぱんだ	🌈👥飼育員とレッサーパンダ
しかばねぱんだ	🌈👥しかばねぱんだ
しのごの	🌈しのごの
しばかるた	🌈👥しばカルタ
しぶやだいがく	🌈👥渋谷大ガク
しゅうじんぐみ	🌈👥囚人組
しりんそう	🌈👥シリンソウ
しんやさんけつあーるけーえす	🌈👥深夜三傑RKS
しーじぶ	🌈👥シージ部
しーずいっきせいしゅっしん	🌈👥SEEDs1期生出身
しーりー	🌈👥SiiRii
じぇーえすぐみ	🌈👥JS組
じぇーけーぐみ	🌈👥JK組
じぇーしーぐみ	🌈👥JCグミ
じのに	🌈👥じ-2
じゅうくねんだんしぐみ	🌈👥19年男子組
じゅうにんといろ	🌈👥十人十色
じょしかいぐみ	🌈👥女子会組
じょしこうはなばたけ	🌈👥女子校花畑
じるじゅえ	🌈👥THE lejouet
すけべぐみ	🌈👥SKB部
すしぐみ	🌈👥SC組
すずかすたーど	🌈👥鈴かすたーど
すとろべあ	🌈👥すとろべあ
すとろべる	🌈👥ストロベル
すめしぐみ	🌈👥SMC組
すももようちえん	🌈👥すもも幼稚園
ずしり	🌈👥ずしり
せれいねじょがくいん	🌈👥世怜音女学院
そうおんしまい	🌈👥騒音姉妹
そでなしぶらっくりりぃ	🌈👥袖無しブラックリリィ
たかじょう	🌈👥鷹匠
たにん	🌈👥他人
だいさんじはい	🌈👥だいさんじ杯
だいなちょう	🌈👥ダイナ蝶
だぶるすりーぶ	🌈👥ダブルスリーブ
だれぱんだ	🌈👥ダレパンダ
ちぇりーぺぇ	🌈👥ちぇりーぺぇ
ちちげやま	🌈👥乳毛山
ちちやま	🌈👥乳山
ちとでびる	🌈👥ちとでびる
ちとろあ	🌈👥ちとろあ
ちみどろこらぼ	🌈👥血みどろコラボ
ちゅーりっぷぐみ	🌈👥チューリップ組
ちりつも	🌈👥ちりつも
ちーかざちー	🌈👥ちーかざちー
ちーはじ	🌈👥ちーハジ
ちーむさつい	🌈👥チーム321
っっｒ	🌈👥RRR
つのぐみ	🌈👥角組
てぃーろわいやる	🌈👥酒と紅茶
てんかいたく	🌈👥天界卓
でぃーのいし	🌈👥Dの石
でびりおん	🌈👥でびリオン
でびるる	🌈👥でびるる
でろちー	🌈👥でろちー
でろもい	🌈👥でろもい
でろもいちー	🌈👥でろもいちー
でろろぎ	🌈👥デロロギ
でろんぼ	🌈👥でろンボ
とぅいんくる	🌈👥Twinkle
とうかざ	🌈👥刀かざ
とうリリ	🌈👥刀リリ
とがのわーる	🌈👥咎ノワール
とがびと	🌈👥†咎人†
とらいと	🌈👥トライト
とりがー	🌈👥トリガー
とりにてぃー	🌈👥▽▲TRiNITY▲▽
どうわぐみ	🌈👥童話組
どくずほんしゃ	🌈👥ド葛本社
どくずほんしゃおるた	🌈👥ド葛本社オルタ
どらひま	🌈👥ドラひま
ないときんぐだむ	🌈👥夜王国
なぞめん	🌈👥NZMN
にきさんきげーまーず	🌈👥にきさんきゲーマーズ
にこいち	🌈👥ニコイチ
にじいろいんく	🌈👥にじ色インク
にじいろきゃんでぃー	🌈👥にじいろきゃんD→☆
にじくじせぶん	🌈👥にじくじ7
にじさんじ	🌈にじさんじ
にじさんじえいがぶ	🌈👥にじさんじ映画部
にじさんじえるふしゅうかい	🌈👥にじさんじエルフ集会
にじさんじえんじぇるず	🌈👥にじさんじえんじぇるず
にじさんじおーばーうぉっちぶ	🌈👥にじさんじOW部
にじさんじきょうけんず	🌈👥にじさんじ狂犬ズ
にじさんじぎゃるず	🌈👥にじさんじGALS
にじさんじぎゃんぐすたー	🌈👥にじさんじギャングスター
にじさんじくけいはくらぶ	🌈👥にじさんじ矩形波倶楽部
にじさんじけーぶるず	🌈👥にじさんじケーブルズ
にじさんじごーみーず	🌈👥にじさんじゴーミーズ
にじさんじしゃどばぶ	🌈👥にじさんじシャドバ部
にじさんじしーず	🌈にじさんじSEEDs
にじさんじすべろう	🌈👥にじさんじスベ狼
にじさんじせいへきこんび	🌈👥にじさんじ性癖コンビ
にじさんじどりくらーず	🌈👥にじさんじドリクラーズ
にじさんじばすたーど	🌈👥にじさんじバスタード
にじさんじぷろじぇくとうぃんたー	🌈👥にじさんじ Project Winter
にじさんじぽんず	🌈👥にじさんじポン酢
にじさんじますこっつ	🌈👥にじさんじマスコッツ
にじさんじようきゃず	🌈👥にじさんじ陽キャズ
にじさんじるーざーず	🌈👥にじさんじLOSERS
にじさんじれいんぼーだんでぃーず	🌈👥にじさんじレインボーダンディーズ
にじさんじれじすたんす	🌈👥にじさんじレジスタンス
にじさんじれじすたんす	🌈👥にじレジ
にじさんじれじすたんすかぶ	🌈👥にじさんじレジスタンス(株)
にじさんじれじすたんすかぶ	🌈👥にじレジ(株)
にじさんじれーるぶ	🌈👥にじさんじレール部
にじてつ	🌈👥にじ鉄
にじゅうななさいらんくたい	🌈👥27歳ランク帯
にじれじ	🌈👥にじレジ
にじれじかぶ	🌈👥にじレジ(株)
にじろっく	🌈👥にじロック
ねこしかかたん	🌈👥猫しか勝たん
ねばーえんず	🌈👥N₠V₠R ₠NDs
のっくあうとふぁいたーず	🌈👥ノックアウトファイターズ
はっしょくおたくさんじゅうし	🌈👥発色オタク三銃士
はっしょくおたくさんじゅうししーずんつー	🌈👥発色オタク三銃士season2
はっぴーとりがー	🌈👥ハッピートリガー
はなのじょしかい	🌈👥花の女子会
はなばたけけ	🌈👥花畑家
はやまいもと	🌈👥はやまいもと
はりおけのおつかい	🌈👥ハリオ家のおつかい
はるいちばん	🌈👥春一番
はるぶし	🌈👥はるぶし
はるみや	🌈👥はるみや
はれび	🌈👥晴レ日
はわちょりすと	🌈👥ハワチョリスト
はーとぐみ	🌈👥はぁと組💙
ばいおれんすたけだ	🌈👥バイオレンス武田(仮)
ばっくすてーじず	🌈👥BACK STAGEs
ばとろわえーちーむ	🌈👥バトロワAチーム
ばねおしぃりぃ	🌈👥ばねおしぃりぃ
ぱりえかわいい	🌈👥パリエかわいい
ぱんこうじょ	🌈👥ぱんコウじょ
ひだまりびより	🌈👥ひだまりびより
ひなちなちま	🌈👥ひなちなちま
ひみつけっしゃぜろ	🌈👥ひみつ結社Xero
ひめべろす	🌈👥ひめべろす
ひもとさいふ	🌈👥ヒモと財布
ひよこぱんつ	🌈👥ひよこぱんつ
ひよこまち	🌈👥ひよこまち
びーじーくらぶ	🌈👥BGクラブ
ぴぴあんどぽぅ	🌈👥ピビandポゥ
ぴゅあぱれっと	🌈👥pure♡palet
ぴわわ	🌈👥ぴわわ
ふぇいす	🌈👥fACe
ふぉーふぉーす	🌈👥4FFFF
ふけいざい	🌈👥フ景罪
ふつまおう	🌈👥祓魔王
ふみとふみ	🌈👥ふみとふみ
ふみのとふみ	🌈👥ふみのとふみ
ふゆれな	🌈👥ふゆれな
ふりょうふし	🌈👥不良不死
ふるーといとい	🌈👥フルートイトイ
ふれぐらんすふぁいぶ	🌈👥Fragrance5
ぶいちゅーばーこうしえん	🌈👥Vtuber甲子園
ぶるーず	🌈👥ぶるーず
ぶれすとぐん	🌈👥ブレスト軍
ぷちさんじ	🌈ぷちさんじ
ぷちふる	🌈👥petit fleurs
ぷちふるーる	🌈👥petit fleurs
ぷらちなまほうけんきゅうじょ	🌈👥白金魔法研究所
ぷりずむりりっく	🌈👥ぷりずむりりっく！
ぷりんあらどーも	🌈👥プリンあらどーも。
ぷりんず	🌈👥ぷりんず
へぶんがーるず	🌈👥ヘブンガールズ
べにずわいがに	🌈👥紅ズワイガニ
べにずわいがにぐんかん	🌈👥紅ズワイガニぐんかん
べるーず	🌈👥べるーず
ほしえび	🌈👥星エビ
ほしとたんてい	🌈👥ホシと探偵
ほしのしすたーず	🌈👥星のシスターズ
ほすきょう	🌈👥ほす☆狂
ほんまのくずや	🌈👥本間ノ葛也
ぼいず	🌈👥VOIZ
ぽさんけ	🌈👥ポ三家
ぽんず	🌈👥にじさんじポン酢
まいごぷろず	🌈👥まいごぷろず
まいもとりきいち	🌈👥舞元力一
ましゅまろくらぶ	🌈👥ましゅまろ倶楽部
まななつ	🌈👥まななつ
まほすず	🌈👥まほすず
ままとものかい	🌈👥ママ友の会
まりあんじゅ	🌈👥まりアンジュ
まんじゅうとしょうろんぽう	🌈👥饅頭と小籠包
みかえる	🌈👥みかえる
みこでび	🌈👥みこでび
みそしる	🌈👥みそしる
みれいじー	🌈👥みれいじー
みれろあ	🌈👥みれロア
むぎたま	🌈👥むぎたま
むーんらいとぶろっさむ	🌈👥月下の桜
めいとばばあ	🌈👥めいとババア
めいふ	🌈👥メイフ
めいふ	🌈👥冥府-UnderWorld-
めしぐみ	🌈👥MC組
めっしゃーず	🌈👥メッシャーズ
めりかる	🌈👥メリカル
めーぶれすとろべあ	🌈👥メーブレストロベア
もぐっとゆず	🌈👥もぐっとゆず
もぐもぐみ	🌈👥もぐも組
もちがえる	🌈👥もちがえる
もちもち	🌈👥もちもち
ももいろおんがくきょうしつ	🌈👥桃色音楽教室
ももいろれいぞうこ	🌈👥桃色冷蔵庫
もやしば	🌈👥もやしば
もりえだ	🌈👥森枝
もるひま	🌈👥もるひま
やおうこく	🌈👥夜王国
やしくず	🌈👥やしくず
やまなつ	🌈👥やまなつ
やんきーぐみ	🌈👥ヤンキー組《楓刀京明千葛》
やんきーぐみ	🌈👥ヤンキー組《楓刀京明雨葛》
ゆうやみ	🌈👥ゆうやみ
ゆきてんぐ	🌈👥ゆきてんぐ
ゆきばれにはなふわり	🌈👥雪晴れに花ふわり
ゆきぼし	🌈👥ゆきぼし
ゆずでび	🌈👥ゆずでび
ゆめかなうしらほし	🌈👥夢叶白星
ゆめのぐらふぃあ	💭ユメノグラフィア
ゆめぱんだ	🌈👥ゆめぱんだ
ゆめぼしけ	🌈👥夢星家
ゆめみづき	🌈👥夢見月
ようきゃーず	🌈👥陽キャーズ
らくよう	🌈👥楽陽
らたとぅいゆやきじゃけ	🌈👥ラタトゥイユ焼鮭
りぜあん	🌈👥リゼアン
りばーし	🌈👥リバーシ
りむみゃあ	🌈👥りむみゃあ
りりぃろーず	🌈👥りりぃろーず
りりかざ	🌈👥リリかざ
りりり	🌈👥RRR
りんかえだぶる	🌈👥りんかえW
るじゅえ	🌈👥le jouet
るーざーきんぐす	🌈👥ルーザーキングス
れいんどろっぷす	🌈👥Rain Drops
れべるえっくす	🌈👥LvEx
れゔぃらん	🌈👥レヴィらん
ろあまりん	🌈👥ロアまりん
ろあるまりん	🌈👥ろあるまりん
ろりぐみ	🌈👥ロリ組
ろるぶ	🌈👥LOL部
わかおかみ	🌈👥若お神
んーまんぼ	🌈👥んーまンボ
ゔぁるつ	🌈👥VΔLZ
ｃｈろのいｒ	🌈👥ChroNoiR
ｒｒｒ	🌈👥RRR
ｓｍｃ	🌈👥SMC組
かなえぼし	🌈👥かなえぼし
かなちーくず	🌈👥かなちーくず
くろゆめまち	🌈👥黒夢町
しぇきなべいぶ	🌈👥シェキナベイ部

! YouTuber・VTuber
! --------------------------------------------------------------------------------
ぶいちゅーばー	バーチャルYouTuber
ｖつべｒ	バーチャルYouTuber
ばーちゃるゆーちゅーばー	バーチャルYouTuber
あおもりりんこ	👤青森りんこ
あさひにいな	👤朝陽にいな
あまつかりりえる	👤天使リリエル
あるこ	👤ARu子
いなばはねる	👤因幡はねる
いぬやまたまき	👤犬山たまき
いまさかはくの	👤今酒ハクノ
うたいめいか	👤歌衣メイカ
かぐらめあ	👤神楽めあ
かふ	🎤花譜
きずなあい	👤キズナアイ
きまぐれくっく	👤きまぐれクック
くいずのっく	👥QuizKnock
くすのきしお	👤楠栞桜
くりむぞん	👤クリムゾン
こかんせんしえむずーん	👤股間戦士エムズーン
さくらかのん	👤桜愛かのん
しろ	👤電脳少女シロ
すずきけんぞう	👤鈴木けんぞう
たきがみりと	👤瀧上りと
でんのうしょじょしろ	👤電脳少女シロ
ほうらいてんてん	👤鳳玲天々
もこう	👤もこう
もものゆらり	👤桃乃ゆらり
ななし	🎤x0o0x
おだのぶひめ	👤織田信姫
やえざわなとり	👤八重沢なとり
めありー	👤めありー

! SLEE
! --------------------------------------------------------------------------------
すりー	👥SLEE
ももはらみのり	👤SLEE ももはらみのり
ひくらかの	👤SLEE 氷儚かの
ひめなぎさ	👤SLEE 姫なぎさ
あかづえまりん	👤SLEE 赤杖まりん

! ホロライブ
! --------------------------------------------------------------------------------
ほろらいぶ	▶ホロライブ
みなとあくあ	▶湊あくあ
ゆづきちょこ	▶癒月ちょこ
おおぞらすばる	▶大空スバル
ほしまちすいせい	▶星街すいせい
がうるぐら	▶Gawr Gura
しらかみふぶき	▶白上フブキ

!	麻雀
! --------------------------------------------------------------------------------
ゆうせー	🀄ゆうせー
うおたにゆみ	🀄魚谷侑未
あさくらこうしん	🀄朝倉康心
おおいたかはる	🀄多井隆晴
さいとうごう	🀄齋藤豪
ひらさわげんき	🀄平澤元気
せんばくろの	🀄千羽黒乃
さきのもこ	🀄咲乃もこ
ざき	🀄ザキ
かもがみにゅう	🀄鴨神にゅう
まーじゃんけいさつひろー	🀄麻雀警察ひろー

!	芸能人・有名人・スポーツ
! --------------------------------------------------------------------------------
たずみりく	👤田角陸
みうらかずよし	👤三浦知良
やまざとりょうた	👤山里亮太
おおさかなおみ	👤大坂なおみ

!	俳優・声優
! --------------------------------------------------------------------------------
あおいゆう	👤蒼井優
おおつかあきお	👤大塚明夫
すわべじゅんいち	👤諏訪部順一
こまつみかこ	👤小松未可子
つぼみ	👤つぼみ
とさかじゅん	👤登坂淳
はなざわかな	👤花澤香菜
かんださやか	👤神田沙也加

!	歌手・アーティスト
! --------------------------------------------------------------------------------
うえはらあずみ	🎤上原あずみ
うる	🎤Uru
がーねっとくろう	🎤GARNET CROW
こまつみほ	🎤小松未歩
そうるどあうと	🎤SOUL'd OUT
りずむ	🎤RYTHEM
くらきまい	🎤倉木麻衣
からふぃな	🎤Kalafina
ふぁな	🎤fhána
ぱふゅーむ	🎤Perfume
さうんどほらいずん	🎤Sound Horizon
こじままゆみ	🎤小島麻由美

!	漫画家・作家
! --------------------------------------------------------------------------------
いとうらいふ	👤伊東ライフ
うえしばりいち	👤植芝理一
いわあきひとし	👤岩明均
うめさおただお	👤梅棹忠夫
かわはられき	👤川原礫
えのもとなりこ	👤榎本ナリコ
きとうもひろ	👤鬼頭莫宏
なかはらちゅうや	👤中原中也
ふんぼ	👤ふんぼ
さいとうたかし	👤齋藤孝
たつきかんとく	👤たつき監督
やましたたいへい	👤山下泰平(kotoriko)
ゆうきひろし	👤結城浩
へらいざー	👤ヘライザー

!	映像作品
! --------------------------------------------------------------------------------
あくせるわーるど	🎥アクセル・ワールド
あにめ	🎥アニメ
えいが	🎥映画
いせかいしょくどう	🎥異世界食堂
えすぱーまみ	🎥エスパー魔美
かぜのたにのなうしか	🎥風の谷のナウシカ
がっこうぐらし	🎥がっこうぐらし！
がて	🎥GATE 自衛隊 彼の地にて、斯く戦えり
けむりくさ	🎥ケムリクサ
げーと	🎥GATE 自衛隊 彼の地にて、斯く戦えり 
このすばらしいせかいにしゅくふくを	🎥この素晴らしい世界に祝福を
こばやしさんちのめいどらごん	🎥小林さんちのメイドラゴン
しゅたいんずげーと	🎥STEINS;GATE
しんせかいより	🎥新世界より
しんちょうゆうしゃ	🎥慎重勇者～この勇者が俺TUEEEくせに慎重すぎる～
じょうかまちのだんでらいおん	🎥城下町のダンデライオン
すずみやはるひのゆううつ	🎥涼宮ハルヒの憂鬱
ぜつえんのてんぺすと	🎥絶園のテンペスト
そーどあーとおんらいん	🎥ソードアート・オンライン
たてのゆうしゃのなりあがり	🎥盾の勇者の成り上がり
だんべるなんきろもてる	🎥ダンベル何キロ持てる？
てんくううのしろらぴゅた	🎥天空の城ラピュタ
てんせいしたらすらいむだったけん	🎥転生したらスライムだった件
でみちゃんはかたりたい	🎥亜人ちゃんは語りたい
はいとげんそうのぐりむがる	🎥灰と幻想のグリムガル
ひょうか	🎥氷菓
へゔぃーおぶじぇくと	🎥ヘヴィーオブジェクト
ほおづきのれいてつ	🎥鬼灯の冷徹
ぼくらの	🎥ぼくらの
まおゆう	🎥まおゆう
まじょのたっきゅうびん	🎥魔女の宅急便
まほうしょうじょいくせいけいかく	🎥魔法少女育成計画
めいたんていこなん	🎥名探偵コナン
めいどいんあびす	🎥メイドインアビス
もーれつぱいれーつ	🎥モーレツ宇宙海賊
ようじょせんき	🎥幼女戦記
らくだいきしのきゃばるりぃ	🎥落第騎士の英雄譚
りぜろからはじめるいせかいせいかつ	🎥Re：ゼロから始める異世界生活
ろぐほらいずん	🎥ログ・ホライズン
ろっかのゆうしゃ	🎥六花の勇者
ろみおのあおいそら	🎥ロミオの青い空
わんぴーす	🎥ONE PIECE
ゔぁいおれっと・えゔぁーがーでん	🎥ヴァイオレット・エヴァーガーデン
ほうかごさいころくらぶ	🎥放課後さいころ倶楽部
からかいじょうずのたかぎさんから	🎥からかい上手の高木さん
きょうかいのかなた	🎥境界の彼方
たまこまーけっと	🎥たまこまーけっと
たまこらぶすとーりー	🎥たまこラブストーリー
けものふれんず	🎥けものフレンズ

!	ゲーム
! --------------------------------------------------------------------------------
あいどるますたー	🎮アイドルマスター
あいどるますたーしゃいにーからーず	🎮シャニマス
あとみくろっぷす	🎮Atomicrops
あぺｘ	🎮Apex Legends
あーく	🎮Ark
えいぺっくす	🎮Apex Legends
かんこれ	🎮艦これ
くらふとぴあ	🎮Craftopia
しゃいます	🎮シャニマス
じゃんたま	🎮雀魂
すぷらとぅーん	🎮Splatoon
すれいざすぱいあ	🎮Slay the Spire
すーぱーまりお	🎮スーパーマリオ
せかいじゅのめいきゅう	🎮世界樹の迷宮
せかいのあそびたいぜん	🎮世界のアソビ大全
てらりあ	🎮Terraria
てんほう	🎮天鳳
でとろいとびかむひゅーまん	🎮Detroit Become Human
どうぶつのもり	🎮どうぶつの森
ふぉーるがいず	🎮Fall Guys
ぶれいぶりーでふぉると	🎮ブレイブリーデフォルト
ぽけっともんすたー	🎮ポケットモンスター
まいんくらふと	🎮Minecraft
まーじゃん	🎮麻雀
めだろっと	🎮メダロット
りんぐふぃっとあどべんちゃー	🎮Ring Fit Adventure
ｓｌｙてぇｓぴれ	🎮Slay the Spire
すまぶら	🎮スマブラ
りずむてんごく	🎮リズム天国
すーぱーどんきーこんぐ	🎮SUPER DONKEY KONG
りーぐおぶれじぇんず	🎮League of Legends
ぜるだのでんせつ	🎮ゼルダの伝説
てとりす	🎮テトリス
まりおかーと	🎮マリオカート
せんねんせんそうあいぎす	🎮千年戦争アイギス
ぷよぷよ	🎮ぷよぷよ
おえかきのもり	🎮おえかきの森
でれすて	🎮デレステ
あまがみ	🎮アマガミ
つぼ	🎮Getting Over It
げってぃんぐおーばーいっと	🎮Getting Over It

!	キャラクター
! --------------------------------------------------------------------------------
あかぎ	⚓赤城
おおい	⚓大井
きたかみ	⚓北上
しぐれ	⚓時雨
しまかぜ	⚓島風
やまと	⚓大和
ゆううだち	⚓夕立
みうらあずさ	👩‍🎤三浦あずさ
おとなしことり	👩‍🎤音無小鳥
ふたみあみ	👩‍🎤双海亜美
あまみはるか	👩‍🎤天海春香
きさらぎちはや	👩‍🎤如月千早
あきづきりつこ	👩‍🎤秋月律子
ほしいみき	👩‍🎤星井美希
みなせいおり	👩‍🎤水瀬伊織
はぎわらゆきほ	👩‍🎤萩原雪歩

!	本/CDのタイトル
! --------------------------------------------------------------------------------
おんとろじー	💿オントロジー
こんてなものがたり	📚コンテナ物語
しなすたじあ	💿シナスタジア
すまっしゅざぺいんと	💿SMASH The PAINT!!
それゆけがっきゅういいんちょう	💿それゆけ! 学級委員長
ちてきせいさんのぎじゅつ	📚知的生産の技術
にじさんじいらすとれーしょん	📚NIJISANJI Illustrations vol.1
ぷりずまてぃっくからーず	💿Prismatic Colors
むーん	💿Moon!!

! 企業
! --------------------------------------------------------------------------------
あすーす	🏢ASUS
あすｓ	🏢ASUS
いちからかぶしきがいしゃ	🏢いちから株式会社
かばーかぶしきがいしゃ	🏢カバー株式会社
きぎょう	🏢企業
きょうとあにめーしょん	🏢京都アニメーション
しゃーぷ	🏢シャープ
でぃーえぬえー	🏢DeNa
にこにこ	🌐niconico
にんてんどう	🏢任天堂
まいくろそふと	🏢Microsoft
みｃろそｆｔ	🏢Microsoft
やふー	🏢ヤフー
すたじおじぶり	🏢スタジオジブリ

! サービス
! --------------------------------------------------------------------------------
google	🌐Google
あまぞん	🌐Amazon
あまぞんぷらいむ	🌐AmazonPrime
あまぷら	🌐AmazonPrime
いんすたぐらむ	🌐Instagram
いんｓたｇらｍ	🌐Instagram
うぃきぺぢあ	🌐Wikipedia
うぃきぺでぃあ	🌐Wikipedia
うぇぶさーびす	🌐Webサービス
うぇｂさーびす	🌐Webサービス
おーぷんれっく	🌐OPENREC
ぎてゅｂ	🌐Github
ぐーぐる	🌐Google
しょーるーむ	🌐SHOWROOM
しょｗろおｍ	🌐SHOWROOM
ちｃとｋ	🌐TikTok
ついったー	🌐Twitter
ついっち	🌐Twitch
てぃっくとっく	🌐TikTok
とぃｔｃｈ	🌐Twitch
のて	🌐note
のーと	🌐note
はてなぶっくまーく	🌐はてなブックマーク
はんげ	🌐hange
びりびり	🌐bilibili
ぴぃｖ	🌐ピクシブ
ぴくしぶ	🌐ピクシブ
ふぁんだむ	🌐Fandom
ふぁんだｍ	🌐Fandom
みらてぃぶ	🌐Mirrative
ゆうつべ	🌐YouTube
ゆーちゅら	🌐ユーチュラ
ゆーちゅーぶ	🌐YouTube
ようつべ	🌐YouTube
かいよう	🌐KAI-YOU.net
ついきゃす	🌐ツイキャス
ぴくしぶ	🌐ピクシブ百科辞典
ぷれいぼーど	🌐PLAYBOARD
ぶいちゅーばーぽすと	🌐Vtuber post
きねん	🏆記念サイト
でーたべーす	🌐データベース
すけぶ	🌐Skeb
ゆーざーろーかる	🌐UserLocal

! インターネット・Web
! --------------------------------------------------------------------------------
くらうどそーしんぐ	クラウドソーシング
ぷっしゅつうち	プッシュ通知
いんたーねっとぶんか	インターネット文化
うぇぶせいさく	Web制作
うぇｂでざいん	Webデザイン
ぶろぐうんえい	ブログ運営

! 技術用語
! --------------------------------------------------------------------------------
あい	⌨AI
あいてぃあーきてくちゃ	⌨ITアーキテクチャ
あぱっちうぇぶさーばー	⌨Apache Web Server
あぴ	⌨API
あｗｓ	⌨AWS
いちんふら	⌨ITインフラ
いｔあーきてくちゃ	⌨ITアーキテクチャ
うぇぶぎじゅつ	⌨Web技術
うぇｂぎじゅつ	⌨Web技術
えいちてぃてぃぴー	⌨HTTP
えすきゅーえる	⌨SQL
えんじにあ	⌨エンジニア
えーあい	⌨AI
えーだぶりゅーえす	⌨AWS
えーぴーあい	⌨API
おっｓ	⌨OSS
おーえすえす	⌨OSS
おーぷんそーすらいせんす	⌨Open Source License
かいはつしゅほう	⌨開発手法
かいはつりふぁれんす	⌨開発リファレンス
きかいがくしゅう	⌨機械学習
ぎっとはぶ	🌐Github
くらうどぎじゅつ	⌨クラウド技術
ぐらふきゅーえる	⌨GraphQL
ごげんご	⌨Go言語
ごーげんご	⌨Go言語
さーくるしーあい	⌨CircleCI
しいあいしいでぃー	⌨CI CD
しぜんげんごしょり	⌨自然言語処理
しんそうがくしゅう	⌨深層学習
しーあいしーでぃー	⌨CI CD
しーえすえす	⌨CSS
じゃばすくりぷと	⌨JavaScript
じゃゔぁｓｃりｐｔ	⌨JavaScript
しすてむせっけい	⌨システム設計
せっけい	⌨システム設計
じょぶかんりしすてむ	⌨ジョブ管理システム
たいぷすくりぷと	⌨TypeScript
てすとしゅほう	⌨ソフトウェアテスト
ばーじょんかんり	⌨バージョン管理
ぱいそん	⌨Python
ぷろぐらみんぐ	⌨プログラミング
まーくだうん	⌨Markdown
もじこーど	⌨文字コード
らいせんす	⌨Open Source License
るびい	⌨Ruby
るびー	⌨Ruby
るびーおんれいるず	⌨Ruby on Rails
るｂｙ	⌨Ruby
れいるす	⌨Ruby on Rails
れいるず	⌨Ruby on Rails
ｃっｓ	⌨CSS
ｈっｔｐ	⌨HTTP
ｐｈｐ	⌨PHP
ｐｙてょｎ	⌨Python
ｓｑｌ	⌨SQL
ようつべだたあぴ	⌨YouTube Data API
ゆーちゅーぶでーたえーぴーあい	⌨YouTube Data API
ぐーぐるでーたえくすぽーと	⌨Google Data Export
googleだたえｘぽｒｔ	⌨Google Data Export

! お仕事
! --------------------------------------------------------------------------------
びじねす	💼ビジネス
あーるぴーえー	💼RPA
えくせる	💼Excel
ぎょうむこうりつか	💼業務効率化
こみゅにけーしょん	💼コミュニケーション
しごとじゅつ	💼仕事術
しごとろん	💼仕事論
じょうほうせきゅりてぃ	💼情報セキュリティ
じんじ	💼人事
せいさんせいこうじょう	💼生産性向上
そしきろん	💼組織論
たすくかんり	💼タスク管理
ちーむびるでぃんぐ	💼チームビルディング
でぃーえっくす	💼DX
でんしさいん	💼電子サイン
どきゅめんてーしょん	💼文書管理
ぶんしょかんり	💼文書管理
ぷれぜんじゅつ	💼プレゼン術
ぷれぜんてーしょん	💼プレゼン術
ぷろじぇくとかんり	💼プロジェクト管理
まいくろそふとおふぃす	💼Microsoft Office
まーけてぃんぐ	💼マーケティング
りもーとわーく	💼リモートワーク
りーがるてっく	💼LegalTech
ｄｘ	💼DX
ｈｒてｃｈ	💼HrTech
ｒぱ	💼RPA
じーてぃーでぃー	💼GTD

! 動画ジャンル
! --------------------------------------------------------------------------------	
あｓｍｒ	👂ASMR
えーえすえむあーる	👂ASMR
きりぬきどうが	✂切り抜き動画
こうさくどうが	🔧工作動画
りょうりどうが	👩‍🍳調理動画
ちょうりどうが	👩‍🍳調理動画
おえかきどうが	🎨お絵かき動画
げーむじっきょうどうが	🎮ゲーム実況動画
ろうどくどうが	📖朗読
きりぬきチャンネル	✂切り抜きチャンネル
ざつだんどうが	🗣雑談
ざつだん	🗣雑談
らじお	🗣ラジオ
ふりーちゃっと	🗣フリーチャット
すいみんどうにゅう	🛏睡眠導入動画

! 🎓学問テーマ
! --------------------------------------------------------------------------------
いｔきょういく	🎓IT教育
えいごがくしゅう	🎓英語学習
げんごがく	🎓言語学
こくさいけいざいほう	🎓国際経済法
しゃかいろん	🎓文化論・社会論
せいじ	🎓歴史・政治
そふとうぇあこうがく	🎓ソフトウェア工学
びじゅつ	🎓美術
ぶんかろん	🎓文化論・社会論
ぶんかろん・しゃかいろん	🎓文化論・社会論
ぼき	🎓簿記
れきし	🎓歴史・政治
れきし・せいじ	🎓歴史・政治
けいざいがく	🎓経済学
ばいおてくのろじー	🎓バイオテクノロジー
すうがく	🎓数学
ぶんがく	🎓文学

!  汎用
! --------------------------------------------------------------------------------
かいもの	🛒買い物
こらむ	📰コラム
じんめい	🍀人名
そふとうぇあ	ソフトウェア
たんごきじ	🍀えとなくりむそん
たんごきじ	🍀単語記事
ついったー	💬つぶやき
つぶやき	💬つぶやき
とぃってｒ	💬つぶやき
とうけいでーた	統計データ
とうこうまとめ	📋投稿まとめ
にゅーす	📰ニュース
ねた	🤣ネタ
ぷれすりりーす	📰プレスリリース
へぇ	💡へぇ
まとめ	📋投稿まとめ

! 食べ物系
! --------------------------------------------------------------------------------
しょくひん	🍴食べ物・飲み物
こんちゅうしょく	🦗昆虫食
おやつ	🍬おかし
おかし	🍬おかし

!  興味・趣味
! --------------------------------------------------------------------------------
あこーでぃおんおんがく	🎧アコーディオン音楽
あろまてらぴー	🌼アロマテラピー
ぃふぇふぁｃｋ	LifeHack
いらすと	🎨イラスト
うたどうが	🎧歌動画
えいせいかんりしゃ	衛生管理者
えんそうどうが	🎧演奏動画
おかね	💰お金
おとそざい	音素材
おーしーあーる	OCR
おーでぃおきき	🎧オーディオ機器
おｃｒ	OCR
かばーそんぐ	🎧カバーソング
かんぜんえいようしょく	🥫完全栄養食
かーどげーむ	🎮カードゲーム
がめ	🎮ゲーム
きょういく	教育・育児
けるとおんがく	🎧ケルト音楽
けんてい	資格・検定
けーぶる	ケーブル
げーむ	🎮ゲーム
こみけ	コミケ
こんかつ	🤵👰婚活
こーひー	☕コーヒー
しかくけんてい	✏資格・検定
しかくしけん	✏資格・検定
しゅうのう	収納
しょせき	📓書籍
しょひょう	📓書評
しーでぃー	💿CD
すぽーつ	スポーツ
へるすけあ	💊ヘルスケア
すまどら	💊スマドラ
かんぽうやく	💊漢方薬
そざい	素材
そっき	速記
たべもの	🍴食べ物・飲み物
たべもの・のみもの	🍴食べ物・飲み物
でざいん	デザイン
でばいす	デバイス
のみもの	🍴食べ物・飲み物
びーじーえむ	🎧BGM
ふぉんと	フォント
ぶんしょうじゅつ	文章術
ぶんぼうぐ	文房具
ぼーどげーむ	🎮ボードゲーム
まんが	📓漫画
もじおこし	文字起こし
もじにゅうりょく	文字入力
らいとのべる	📓ライトノベル
らいふはっく	LifeHack
ゔぁぺ	VAPE
ゔぇーぷ	VAPE
ｂｇｍ	🎧BGM
ｃｄ	💿CD
じんぶつ	👤
ｇｔｄ	GTD
ぷらもでる	プラモデル
こうかおん	📣効果音

! 🔖 テーマ
! --------------------------------------------------------------------------------
いのちのかがやき	🔖いのちの輝き
いーしーそうどう	🔖ec騒動
えいぺっくすぶにじさんじきるりれー	🔖APEX部2434キルリレー
えｃそうどう	🔖ec騒動
かいてきにいえですごす	🔖快適に家で過ごす
きょうあにほうかさつじんじけん	🔖京アニ放火殺人事件
きょうとあにめーしょん	🔖京アニ放火殺人事件
しょせきのでんしか	🔖書籍の電子化
ちてきせいさんのぎじゅつ	🔖知的生産の技術
にじさんじひゃっきやこう	🔖にじさんじ百鬼夜行
ふりーじあたいきゅう	🔖フリージア耐久
せんばくろのまーじゃんきょうしつ	🔖千羽黒乃麻雀教室
いんどにじさんじ	🔖インド(にじさんじ)
かんこれ	🔖艦これ攻略情報
にじさばなつまつり	🔖にじ鯖夏祭り2020
てーま	🔖
にじさんじあにばーさりーふぇすてぃばる	🔖🌈にじFes2021
にじふぇす	🔖🌈にじFes2021
にじさんじこうしえん	🔖にじさんじ甲子園