VTuber切り抜きの沼,3Dさんばか	🌈アンジュ・カトリ…
VTuber切り抜きの沼,3Dさんばか	🌈リゼ・ヘルエスタ
VTuber切り抜きの沼,3Dさんばか	🌈戌亥とこ
VTuber切り抜きの沼,3Dさんばか	🌈👥さんばか
VTuber切り抜きの沼,AI	🌈😥出雲霞
VTuber切り抜きの沼,Bora	🌈🇰🇷 Bora Nun
VTuber切り抜きの沼,Elu	🌈エルフのえる
VTuber切り抜きの沼,GIBARA	🌈御伽原江良
VTuber切り抜きの沼,Hana	🌈🇮🇩 Hana Macchia
VTuber切り抜きの沼,Hana_Macchia	🌈🇮🇩 Hana Macchia
VTuber切り抜きの沼,Hanaちゃん	🌈🇮🇩 Hana Macchia
VTuber切り抜きの沼,KUZUHA	🌈葛葉
VTuber切り抜きの沼,Kenmochi	🌈剣持刀也
VTuber切り抜きの沼,Layla	🌈🇮🇩 Layla Alstroemeria
VTuber切り抜きの沼,Nagi	🌈🇰🇷 So Nagi
VTuber切り抜きの沼,Noor	🌈🇮🇳 Noor(ヌール)
VTuber切り抜きの沼,SMC	🌈加賀美ハヤト
VTuber切り抜きの沼,SMC	🌈夜見れな
VTuber切り抜きの沼,SMC	🌈👥SMC組
VTuber切り抜きの沼,Sasaki Saku	🌈笹木咲
VTuber切り抜きの沼,Suha	🌈🇰🇷 Min Suha
VTuber切り抜きの沼,Suzuhara Lulu	🌈鈴原るる
VTuber切り抜きの沼,YASHIRO	🌈社築
VTuber切り抜きの沼,Yuya	🌈🇰🇷 Shin Yuya
VTuber切り抜きの沼,Yuyaちゃん	🌈🇰🇷 Shin Yuya
VTuber切り抜きの沼,ZEA	🌈🇮🇩 ZEA Cornelia
VTuber切り抜きの沼,あみゃみゃ	🌈天宮こころ
VTuber切り抜きの沼,いちご	🌈宇志海いちご
VTuber切り抜きの沼,いちごちゃん	🌈宇志海いちご
VTuber切り抜きの沼,いにゅい	🌈戌亥とこ
VTuber切り抜きの沼,いろは	🌈🇰🇷 Lee Roha
VTuber切り抜きの沼,ういは	🌈相羽ういは
VTuber切り抜きの沼,ういはちゃん	🌈相羽ういは
VTuber切り抜きの沼,うさちゃん先生	🌈郡道美玲
VTuber切り抜きの沼,えま	🌈えま★おうがすと
VTuber切り抜きの沼,えまかざ	🌈えま★おうがすと
VTuber切り抜きの沼,えまかざ	🌈森中花咲
VTuber切り抜きの沼,える	🌈エルフのえる
VTuber切り抜きの沼,えるちゃん	🌈エルフのえる
VTuber切り抜きの沼,えるの	🌈エルフのえる
VTuber切り抜きの沼,お嬢様	🌈🇰🇷 So Nagi
VTuber切り抜きの沼,かいくん	🌈黛灰
VTuber切り抜きの沼,かざちゃん	🌈森中花咲
VTuber切り抜きの沼,かざママ	🌈森中花咲
VTuber切り抜きの沼,かなかな	🌈叶
VTuber切り抜きの沼,くずぷて	🌈ラトナ・プティ
VTuber切り抜きの沼,くずぷて	🌈葛葉
VTuber切り抜きの沼,こんるる	🌈鈴原るる
VTuber切り抜きの沼,ござるる	🌈本間ひまわり
VTuber切り抜きの沼,ござるる	🌈鈴原るる
VTuber切り抜きの沼,さんばか切り抜きチャンネル	✂切り抜き動画
VTuber切り抜きの沼,しぃしぃ	🌈椎名唯華
VTuber切り抜きの沼,しいしい	🌈椎名唯華
VTuber切り抜きの沼,しずりん	🌈静凛
VTuber切り抜きの沼,すこや	🌈健屋花那
VTuber切り抜きの沼,ちひろ	🌈勇気ちひろ
VTuber切り抜きの沼,ちーくん	🌈勇気ちひろ
VTuber切り抜きの沼,ちーさん	🌈勇気ちひろ
VTuber切り抜きの沼,ちーちゃん	🌈勇気ちひろ
VTuber切り抜きの沼,でびでび	🌈でびでび・でびる
VTuber切り抜きの沼,でびる	🌈でびでび・でびる
VTuber切り抜きの沼,でび先輩	🌈でびでび・でびる
VTuber切り抜きの沼,でび様	🌈でびでび・でびる
VTuber切り抜きの沼,とこちゃん	🌈戌亥とこ
VTuber切り抜きの沼,とこアン	🌈👥とこアン
VTuber切り抜きの沼,とっとこベル太郎	🌈ベルモンド・バン…
VTuber切り抜きの沼,なぎお嬢様	🌈🇰🇷 So Nagi
VTuber切り抜きの沼,なちゅめ	🌈来栖夏芽
VTuber切り抜きの沼,なるせくん	🌈成瀬鳴
VTuber切り抜きの沼,にじさんじ切り抜き	🌈にじさんじまとめ
VTuber切り抜きの沼,にじレジ	🌈椎名唯華
VTuber切り抜きの沼,にじレジ	🌈花畑チャイカ
VTuber切り抜きの沼,にじレジ	🌈👥にじレジ
VTuber切り抜きの沼,はかちぇ	🌈葉加瀬冬雪
VTuber切り抜きの沼,ひま	🌈本間ひまわり
VTuber切り抜きの沼,ひまぐま	🌈本間ひまわり
VTuber切り抜きの沼,ひまちゃん	🌈本間ひまわり
VTuber切り抜きの沼,ひまわり	🌈本間ひまわり
VTuber切り抜きの沼,ふわくん	🌈不破湊
VTuber切り抜きの沼,ふわっち	🌈不破湊
VTuber切り抜きの沼,ふわみなと	🌈不破湊
VTuber切り抜きの沼,ぷてち	🌈ラトナ・プティ
VTuber切り抜きの沼,ほんひま	🌈本間ひまわり
VTuber切り抜きの沼,ぼらちゃん	🌈🇰🇷 Bora Nun
VTuber切り抜きの沼,まちゅかい	🌈魔使マオ
VTuber切り抜きの沼,まひまひ	🌈雪城眞尋
VTuber切り抜きの沼,まひろ	🌈雪城眞尋
VTuber切り抜きの沼,まゆゆ	🌈黛灰
VTuber切り抜きの沼,めいじーちゃん	🌈童田明治
VTuber切り抜きの沼,もやし	🌈夢追翔
VTuber切り抜きの沼,やしきず	🌈社築
VTuber切り抜きの沼,ゆめお	🌈夢追翔
VTuber切り抜きの沼,らんねーちゃん	🌈早瀬走
VTuber切り抜きの沼,りりむ	🌈魔界ノりりむ
VTuber切り抜きの沼,りりむちゃん	🌈魔界ノりりむ
VTuber切り抜きの沼,るるちゃん	🌈鈴原るる
VTuber切り抜きの沼,アキくん	🌈鈴谷アキ
VTuber切り抜きの沼,アキーナ	🌈三枝明那
VTuber切り抜きの沼,アゴくん	🌈剣持刀也
VTuber切り抜きの沼,アッキーナ	🌈三枝明那
VTuber切り抜きの沼,アルス	🌈アルス・アルマル
VTuber切り抜きの沼,アルマル	🌈アルス・アルマル
VTuber切り抜きの沼,アレクシード	🌈葛葉
VTuber切り抜きの沼,アンジュ	🌈アンジュ・カトリ…
VTuber切り抜きの沼,アンジュ	🌈アンジュ・カトリ…
VTuber切り抜きの沼,アンニュイ	🌈アンジュ・カトリ…
VTuber切り抜きの沼,アンニュイ	🌈ニュイ・ソシエール
VTuber切り抜きの沼,アンニュイ	🌈👥アンニュイ
VTuber切り抜きの沼,イブ	🌈イブラヒム
VTuber切り抜きの沼,エクス	🌈エクス・アルビオ
VTuber切り抜きの沼,エビオ	🌈エクス・アルビオ
VTuber切り抜きの沼,エリー	🌈エリー・コニファー
VTuber切り抜きの沼,エリーちゃん	🌈エリー・コニファー
VTuber切り抜きの沼,エル	🌈エルフのえる
VTuber切り抜きの沼,エルフえる	🌈エルフのえる
VTuber切り抜きの沼,オワリ君	🌈❜ 渋谷オワリ
VTuber切り抜きの沼,オワリ君	🌈渋谷ハジメ
VTuber切り抜きの沼,カトリーナ	🌈アンジュ・カトリ…
VTuber切り抜きの沼,カルタ	🌈山神カルタ
VTuber切り抜きの沼,ギバラ	🌈御伽原江良
VTuber切り抜きの沼,クレア	🌈シスター・クレア
VTuber切り抜きの沼,クレア様	🌈シスター・クレア
VTuber切り抜きの沼,コアラ	🌈でびでび・でびる
VTuber切り抜きの沼,コウ	🌈卯月コウ
VTuber切り抜きの沼,コニファー	🌈エリー・コニファー
VTuber切り抜きの沼,コハク	🌈東堂コハク
VTuber切り抜きの沼,シェリン	🌈シェリン・バーガ…
VTuber切り抜きの沼,ジョー・カー	🌈ジョー・力一
VTuber切り抜きの沼,ソシえもん	🌈ニュイ・ソシエール
VTuber切り抜きの沼,チグサ	🌈西園チグサ
VTuber切り抜きの沼,デビル	🌈でびでび・でびる
VTuber切り抜きの沼,ナギ	🌈🇰🇷 So Nagi
VTuber切り抜きの沼,ニュイ	🌈ニュイ・ソシエール
VTuber切り抜きの沼,ニュイちゃん	🌈ニュイ・ソシエール
VTuber切り抜きの沼,ヌンボラ	🌈🇰🇷 Bora Nun
VTuber切り抜きの沼,ヌン・ボラ	🌈🇰🇷 Bora Nun
VTuber切り抜きの沼,ハジキ	🌈渋谷ハジメ
VTuber切り抜きの沼,ハジメ	🌈渋谷ハジメ
VTuber切り抜きの沼,ハナちゃん	🌈🇮🇩 Hana Macchia
VTuber切り抜きの沼,ハナマキ	🌈🇮🇩 Hana Macchia
VTuber切り抜きの沼,ハヤトくん	🌈加賀美ハヤト
VTuber切り抜きの沼,バネキ	🌈赤羽葉子
VTuber切り抜きの沼,バーガンディー	🌈シェリン・バーガ…
VTuber切り抜きの沼,ヒスイ	🌈北小路ヒスイ
VTuber切り抜きの沼,ヒスピ	🌈北小路ヒスイ
VTuber切り抜きの沼,フレン	🌈フレン・Ｅ・ルス…
VTuber切り抜きの沼,ブラヒム	🌈イブラヒム
VTuber切り抜きの沼,プティ	🌈ラトナ・プティ
VTuber切り抜きの沼,ヘルエスタ	🌈リゼ・ヘルエスタ
VTuber切り抜きの沼,ベルさん	🌈でびでび・でびる
VTuber切り抜きの沼,ベルさん	🌈ベルモンド・バン…
VTuber切り抜きの沼,ベルアン	🌈アンジュ・カトリ…
VTuber切り抜きの沼,ベルアン	🌈ベルモンド・バン…
VTuber切り抜きの沼,ベルモンド	🌈ベルモンド・バン…
VTuber切り抜きの沼,ボラちゃん	🌈🇰🇷 Bora Nun
VTuber切り抜きの沼,マオ	🌈魔使マオ
VTuber切り抜きの沼,マスクドいちから	🌈舞元啓介
VTuber切り抜きの沼,マツカイ	🌈魔使マオ
VTuber切り抜きの沼,ママ宮リオン	🌈鷹宮リオン
VTuber切り抜きの沼,ママ川サラ	🌈星川サラ
VTuber切り抜きの沼,マリンアルマル	🌈アルス・アルマル
VTuber切り抜きの沼,マリンアルマル	🌈葉山舞鈴
VTuber切り抜きの沼,マルマル	🌈アルス・アルマル
VTuber切り抜きの沼,メリッサ	🌈メリッサ・キンレ…
VTuber切り抜きの沼,リオン様	🌈鷹宮リオン
VTuber切り抜きの沼,リゼ	🌈リゼ・ヘルエスタ
VTuber切り抜きの沼,リゼアン	🌈アンジュ・カトリ…
VTuber切り抜きの沼,リゼアン	🌈リゼ・ヘルエスタ
VTuber切り抜きの沼,リゼアン	🌈👥リゼアン
VTuber切り抜きの沼,リゼ・マザーエスタ	🌈リゼ・ヘルエスタ
VTuber切り抜きの沼,リゼ様	🌈リゼ・ヘルエスタ
VTuber切り抜きの沼,リゼ皇女	🌈リゼ・ヘルエスタ
VTuber切り抜きの沼,リリ	🌈夕陽リリ	リリム
VTuber切り抜きの沼,リリ	🌈夕陽リリ
VTuber切り抜きの沼,リリム	🌈魔界ノりりむ
VTuber切り抜きの沼,ルイス	🌈ルイス・キャミー
VTuber切り抜きの沼,ルンパッパ	🌈本間ひまわり
VTuber切り抜きの沼,レッサーパンダ	🌈ラトナ・プティ
VTuber切り抜きの沼,レヴィ	🌈レヴィ・エリファ
VTuber切り抜きの沼,レヴィちゃん	🌈レヴィ・エリファ
VTuber切り抜きの沼,ロア	🌈夢月ロア
VTuber切り抜きの沼,ロアちゃん	🌈夢月ロア
VTuber切り抜きの沼,ンゴちゃん	🌈周央サンゴ
VTuber切り抜きの沼,不破	🌈不破湊
VTuber切り抜きの沼,久遠	🌈😥久遠千歳
VTuber切り抜きの沼,伏見	🌈伏見ガク
VTuber切り抜きの沼,俺持刀也	🌈剣持刀也
VTuber切り抜きの沼,健屋	🌈健屋花那
VTuber切り抜きの沼,冥府	🌈👥メイフ
VTuber切り抜きの沼,冬雪	🌈葉加瀬冬雪
VTuber切り抜きの沼,凛先輩	🌈静凛
VTuber切り抜きの沼,剣持	🌈剣持刀也
VTuber切り抜きの沼,剣持家	🌈剣持刀也
VTuber切り抜きの沼,加賀美	🌈加賀美ハヤト
VTuber切り抜きの沼,加賀美少年	🌈加賀美ハヤト
VTuber切り抜きの沼,加賀美社長	🌈加賀美ハヤト
VTuber切り抜きの沼,千歳	🌈😥久遠千歳
VTuber切り抜きの沼,卯月	🌈卯月コウ
VTuber切り抜きの沼,叶	🌈叶
VTuber切り抜きの沼,四皇・叶	🌈叶
VTuber切り抜きの沼,夕日	🌈夕陽リリ	ロリリオン
VTuber切り抜きの沼,夢追	🌈夢追翔
VTuber切り抜きの沼,天宮	🌈天宮こころ
VTuber切り抜きの沼,委員長	🌈月ノ美兎
VTuber切り抜きの沼,宇志海	🌈宇志海いちご
VTuber切り抜きの沼,尊ママ	🌈竜胆尊
VTuber切り抜きの沼,尊様		🌈竜胆尊
VTuber切り抜きの沼,尊様	🌈竜胆尊
VTuber切り抜きの沼,小夜ちゃん	🌈雨森小夜
VTuber切り抜きの沼,山神	🌈山神カルタ
VTuber切り抜きの沼,崎エアル	🌈春崎エアル
VTuber切り抜きの沼,弦月	🌈弦月藤士郎
VTuber切り抜きの沼,悪魔でびる	🌈でびでび・でびる
VTuber切り抜きの沼,愛園	🌈愛園愛美
VTuber切り抜きの沼,戌 亥	🌈戌亥とこ
VTuber切り抜きの沼,戌亥	🌈戌亥とこ
VTuber切り抜きの沼,成瀬	🌈成瀬鳴
VTuber切り抜きの沼,戦国ＡＲＫ	🎮Ark
VTuber切り抜きの沼,戦国ＡＲＫ	🔖🌈にじ鯖Ark
VTuber切り抜きの沼,早瀬	🌈早瀬走
VTuber切り抜きの沼,明楽レイ	🌈🇰🇷 Akira Ray
VTuber切り抜きの沼,明那	🌈三枝明那
VTuber切り抜きの沼,星川	🌈星川サラ
VTuber切り抜きの沼,春先	🌈春崎エアル
VTuber切り抜きの沼,春崎	🌈春崎エアル
VTuber切り抜きの沼,有栖	🌈物述有栖
VTuber切り抜きの沼,有栖ちゃん	🌈物述有栖
VTuber切り抜きの沼,未来人	🌈夕陽リリ
VTuber切り抜きの沼,桃ちゃん	🌈安土桃
VTuber切り抜きの沼,桜凜月	🌈桜凛月
VTuber切り抜きの沼,森中	🌈森中花咲
VTuber切り抜きの沼,椎名	🌈椎名唯華
VTuber切り抜きの沼,椎名さん	🌈椎名唯華
VTuber切り抜きの沼,瀬戸	🌈瀬戸美夜子
VTuber切り抜きの沼,王子	🌈春崎エアル
VTuber切り抜きの沼,理是･地獄絵巣太皇女	🌈リゼ・ヘルエスタ
VTuber切り抜きの沼,甲斐田	🌈甲斐田晴
VTuber切り抜きの沼,皇女	🌈リゼ・ヘルエスタ
VTuber切り抜きの沼,看護師	🌈健屋花那
VTuber切り抜きの沼,石油王	🌈イブラヒム
VTuber切り抜きの沼,社	🌈社築
VTuber切り抜きの沼,社パパ	🌈社築
VTuber切り抜きの沼,社長	🌈加賀美ハヤト
VTuber切り抜きの沼,神田	🌈神田笑一
VTuber切り抜きの沼,神田くん	🌈神田笑一
VTuber切り抜きの沼,竜胆	🌈竜胆尊
VTuber切り抜きの沼,笹木	🌈笹木咲
VTuber切り抜きの沼,美夜子	🌈瀬戸美夜子
VTuber切り抜きの沼,舞メア	🌈舞元啓介
VTuber切り抜きの沼,舞メア	👤神楽めあ
VTuber切り抜きの沼,舞鈴ちゃん	🌈葉山舞鈴
VTuber切り抜きの沼,花畑	🌈花畑チャイカ
VTuber切り抜きの沼,花畑ママ	🌈花畑チャイカ
VTuber切り抜きの沼,英雄	🌈エクス・アルビオ
VTuber切り抜きの沼,英雄と魔法使い	🌈アルス・アルマル
VTuber切り抜きの沼,英雄と魔法使い	🌈エクス・アルビオ
VTuber切り抜きの沼,葉加瀬	🌈葉加瀬冬雪
VTuber切り抜きの沼,葉山	🌈葉山舞鈴
VTuber切り抜きの沼,西園ちぐさ	🌈西園チグサ
VTuber切り抜きの沼,詩子	🌈鈴鹿詩子
VTuber切り抜きの沼,詩子お姉さん	🌈鈴鹿詩子
VTuber切り抜きの沼,詩子さん	🌈鈴鹿詩子
VTuber切り抜きの沼,轟狂子	🌈轟京子
VTuber切り抜きの沼,遠北	🌈😥遠北千南
VTuber切り抜きの沼,郡道	🌈郡道美玲
VTuber切り抜きの沼,野良猫	🌈文野環
VTuber切り抜きの沼,鈴原	🌈鈴原るる
VTuber切り抜きの沼,錬金術師	🌈アンジュ・カトリ…
VTuber切り抜きの沼,長尾	🌈長尾景
VTuber切り抜きの沼,雪城	🌈雪城眞尋
VTuber切り抜きの沼,霞ちゃん	🌈😥出雲霞
VTuber切り抜きの沼,駿河屋れな	🌈夜見れな
VTuber切り抜きの沼,魔使	🌈魔使マオ
VTuber切り抜きの沼,魔界ノ	🌈魔界ノりりむ
VTuber切り抜きの沼,鷹宮	🌈鷹宮リオン
VTuber切り抜きの沼,黛	🌈黛灰
VTuber切り抜きの沼,黛改	🌈黛灰
VTuber切り抜きの沼,卯月	卯月コウ
VTuber切り抜きの沼,ヤシロ	🌈社築
VTuber切り抜きの沼,オカン	🌈早瀬走
VTuber切り抜きの沼,もののべありす	[🌈物述有栖]
VTuber切り抜きの沼,バーガンディ	[🌈シェリン・バーガ…]
