
くろのわちー	🌈👥ChroNoiR
🌈👥ぐんかんフラワ…	🌈👥ぐんかん
🌈👥紅ズワイガニぐ…	🌈👥ぐんかん
🌈👥紅ズワイガニぐ…	🌈👥紅ズワイガニ
🎧Deceit	🎮ゲーム実況
🎧Deceit	🎮ホラゲ実況
🎮7 Days to Die	🎮ゲーム実況
🎮Apex Legends	🎮ゲーム実況
🎮Ark	🎮ゲーム実況
🎮Craftopia	🎮ゲーム実況
🎮DbD	🎮ゲーム実況
🎮Detroit Become Human	🎮ゲーム実況
🎮Fall Guys	🎮ゲーム実況
🎮Fortnite	🎮ゲーム実況
🎮GTA	🎮ゲーム実況
🎮Getting Over It	🎮ゲーム実況
🎮League of Legends	🎮ゲーム実況
🎮Minecraft	🎮ゲーム実況
🎮OUTLAST	🎮ゲーム実況
🎮OUTLAST	🎮ゲーム実況
🎮OUTLAST	🎮ホラゲ実況
🎮OUTLAST	🎮ホラゲ実況
🎮PUBG	🎮ゲーム実況
🎮Portal	🎮ゲーム実況
🎮Raft	🎮ゲーム実況
🎮Ring Fit Adventure	🎮ゲーム実況
🎮SEKIRO	🎮ゲーム実況
🎮SEKIRO	🎮ゲーム実況
🎮SUPER DONKEY KONG	🎮ゲーム実況
🎮Splatoon	🎮ゲーム実況
🎮Stardew Valley	🎮ゲーム実況
🎮The Forest	🎮ゲーム実況
🎮The House	🎮ゲーム実況
🎮The House	🎮ホラゲ実況
🎮UNDERTALE	🎮ゲーム実況
🎮UNO	🎮ゲーム実況
🎮VALORANT	🎮ゲーム実況
🎮ときメモ	🎮ゲーム実況
🎮どうぶつの森	🎮ゲーム実況
🎮ぼくのなつやすみ	🎮ゲーム実況
🎮スーパーマリオ	🎮ゲーム実況
🎮ゼルダの伝説	🎮ゲーム実況
🎮ダークソウル	🎮ゲーム実況
🎮トレバ	🎮ゲーム実況
🎮ドラゴンクエスト	🎮ゲーム実況
🎮バカゲー実況	🎮ゲーム実況
🎮バカゲー実況	🎮ゲーム実況
🎮ピクミン	🎮ゲーム実況
🎮ホラゲ実況	🎮ゲーム実況
🎮ポケットモンスター	🎮ゲーム実況
🎮ポケモンスナップ	🎮ゲーム実況
🎮マリオRPG	🎮スーパーマリオ
🎮マリオカート	🎮ゲーム実況
🎮モンスターハンター	🎮ゲーム実況
🎮ルイージマンション	🎮ゲーム実況
🎮ロックマン	🎮ゲーム実況
🎮世界のアソビ大全	🎮ゲーム実況
🎮事故物件	🎮ゲーム実況
🎮事故物件	🎮ホラゲ実況
🎮人喰いの大鷲トリコ	🎮ゲーム実況
🎮千年戦争アイギス	🎮ゲーム実況
🎮原神	🎮ゲーム実況
🎮夜廻	🎮ゲーム実況
🎮夜廻	🎮ホラゲ実況
🎮幽霊列車	🎮ゲーム実況
🎮幽霊列車	🎮ホラゲ実況
🎮空気読み	🎮ゲーム実況
🎮空気読み	🎮ホラゲ実況
🎮行方不明	🎮ゲーム実況
🎮行方不明	🎮ホラゲ実況
🎮行方不明	🎮ホラゲ実況
🎮雀魂	🎮ゲーム実況
🎮麻雀	🎮ゲーム実況
🔖🌈ゆびをふる杯	🔖🌈ゆびをふる
🎮夜勤事件	🎮ホラゲ実況
🎮夜勤事件	🎮ゲーム実況
🎧Deceit	🎮ゲーム実況
🎮Overwatch	🎮ゲーム実況
🎮つぐのひ	🎮ホラゲ実況
🎮脳トレ	🎮ゲーム実況
🎮HITMAN	🎮ゲーム実況
🎮Besiege	🎮ゲーム実況
🎮Super Bunny Man	🎮ゲーム実況
🎮Muse Dash	🎮ゲーム実況
🎮塊魂	🎮ゲーム実況
🎮ロードモバイル	🎮ゲーム実況
🎮Rocket League	🎮ゲーム実況
🎮ポケモンスナップ	🎮ポケットモンスター
🎮Overcooked	🎮ゲーム実況
🎮ビビッドアーミー	🎮ゲーム実況
🎮マリオメーカー	🎮スーパーマリオ
🎮犬鳴トンネル	🎮ホラゲ実況
🎮Friday the 13th	🎮ゲーム実況
🎮影廊	🎮ホラゲ実況
🎮Pacify	🎮ホラゲ実況
🎮メイドインワリオ	🎮ゲーム実況
🎮Good Job!	🎮ゲーム実況
🎮Dead by Daylight	🎮DbD