













#ã‘ã„ã‚ã„	[ğŸŒˆç›¸ç¾½ã†ã„ã¯]
#ã‘ã„ã‚ã„	[ğŸŒˆé•·å°¾æ™¯]
#ã‘ã„ã‚ã„	[ğŸŒˆğŸ‘¥ã‘ã„ã‚ã„]
2434ã‚­ãƒ«ãƒªãƒ¬ãƒ¼	[ğŸ”–APEXéƒ¨2434ã‚­ãƒ«ãƒªãƒ¬ãƒ¼]
Fixã‚µãƒ¼	[ğŸŒˆã§ã³ã§ã³ãƒ»ã§ã³ã‚‹]
Fixã‚µãƒ¼	[ğŸŒˆã‚¤ãƒ–ãƒ©ãƒ’ãƒ ]
Fixã‚µãƒ¼	[ğŸŒˆãƒ¬ãƒ´ã‚£ãƒ»ã‚¨ãƒªãƒ•ã‚¡]
Fixã‚µãƒ¼	[ğŸŒˆæ—©ç€¬èµ°]
Fixã‚µãƒ¼	[ğŸŒˆæ¸‹è°·ãƒã‚¸ãƒ¡]
Fixã‚µãƒ¼	[ğŸŒˆèŠ±ç•‘ãƒãƒ£ã‚¤ã‚«]
Fixã‚µãƒ¼	[ğŸŒˆè‘›è‘‰]
Fixã‚µãƒ¼	[ğŸŒˆğŸ‘¥Fixã‚µãƒ¼]
KEYWORD	TAG	EXCLUDE
OTNKçµ„	[ğŸŒˆå¤¢è¿½ç¿”]
OTNKçµ„	[ğŸŒˆç¤¾ç¯‰]
OTNKçµ„	[ğŸŒˆèŠ±ç•‘ãƒãƒ£ã‚¤ã‚«]
OTNKçµ„	[ğŸŒˆğŸ‘¥OTNKçµ„]
OTNKçµ„	[ğŸŒˆğŸ˜¥åä¼½å°¾ã‚¢ã‚ºãƒ]
Yuya Shin	[ğŸŒˆğŸ‡°ğŸ‡· Shin Yuya]
www.youtube.com/watch,AIã¨åˆ‡ã‚ŠæŠœã,Bora	[ğŸŒˆğŸ‡°ğŸ‡· Bora Nun]
www.youtube.com/watch,AIã¨åˆ‡ã‚ŠæŠœã,Yuyaã¡ã‚ƒã‚“	[ğŸŒˆğŸ‡°ğŸ‡· Shin Yuya]
www.youtube.com/watch,AIã¨åˆ‡ã‚ŠæŠœã,ã‚¸ãƒ§ãƒ¼ãƒ»ã‚«ãƒ¼	[ğŸŒˆã‚¸ãƒ§ãƒ¼ãƒ»åŠ›ä¸€]
www.youtube.com/watch,AIã¨åˆ‡ã‚ŠæŠœã,ãƒ¡ãƒªãƒƒã‚µãƒ»ã‚­ãƒ³ã‚«ãƒ³	[ğŸŒˆãƒ¡ãƒªãƒƒã‚µãƒ»ã‚­ãƒ³ãƒ¬â€¦]
www.youtube.com/watch,AIã¨åˆ‡ã‚ŠæŠœã,ãƒ¤ãƒ³ã‚­ãƒ¼ã‚³ãƒã‚¯	[ğŸŒˆæ±å ‚ã‚³ãƒã‚¯]
www.youtube.com/watch,AIã¨åˆ‡ã‚ŠæŠœã,éƒ¡é“å…ˆç”Ÿ	[ğŸŒˆéƒ¡é“ç¾ç²]
www.youtube.com/watch,APXE	ğŸ®Apex Legends
www.youtube.com/watch,ASTRAL CHAIN	ğŸ®ã‚²ãƒ¼ãƒ å®Ÿæ³
www.youtube.com/watch,Among Us	ğŸ®ã‚²ãƒ¼ãƒ å®Ÿæ³
www.youtube.com/watch,ApexLegends	ğŸ®Apex Legends
www.youtube.com/watch,Automachef	ğŸ®ã‚²ãƒ¼ãƒ å®Ÿæ³
www.youtube.com/watch,Bridge Constructor Portal	ğŸ®ã‚²ãƒ¼ãƒ å®Ÿæ³
www.youtube.com/watch,CHKN	ğŸ®ã‚²ãƒ¼ãƒ å®Ÿæ³
www.youtube.com/watch,CoD:ã‚¦ã‚©ãƒ¼ã‚¾ãƒ¼ãƒ³	ğŸ®ã‚²ãƒ¼ãƒ å®Ÿæ³
www.youtube.com/watch,Cytus	ğŸ®ã‚²ãƒ¼ãƒ å®Ÿæ³
www.youtube.com/watch,Death Squared	ğŸ®ã‚²ãƒ¼ãƒ å®Ÿæ³
www.youtube.com/watch,Emily Wants to Play	ğŸ®ã‚²ãƒ¼ãƒ å®Ÿæ³
www.youtube.com/watch,FTHE DIVSION2	ğŸ®ã‚²ãƒ¼ãƒ å®Ÿæ³
www.youtube.com/watch,Forest	ğŸ®The Forest
www.youtube.com/watch,GARAGE	ğŸ®ã‚²ãƒ¼ãƒ å®Ÿæ³
www.youtube.com/watch,Ghostrunner Demo	ğŸ®ã‚²ãƒ¼ãƒ å®Ÿæ³
www.youtube.com/watch,Gladiabots	ğŸ®ã‚²ãƒ¼ãƒ å®Ÿæ³
www.youtube.com/watch,Golf Peaks	ğŸ®ã‚²ãƒ¼ãƒ å®Ÿæ³
www.youtube.com/watch,Hacktag	ğŸ®ã‚²ãƒ¼ãƒ å®Ÿæ³
www.youtube.com/watch,HyperScape	ğŸ®ã‚²ãƒ¼ãƒ å®Ÿæ³
www.youtube.com/watch,Legal Dungeon	ğŸ®ã‚²ãƒ¼ãƒ å®Ÿæ³
www.youtube.com/watch,Minecrft	ğŸ®Minecraft
www.youtube.com/watch,Mortal Shell	ğŸ®ã‚²ãƒ¼ãƒ å®Ÿæ³
www.youtube.com/watch,My Friend Pedro	ğŸ®ã‚²ãƒ¼ãƒ å®Ÿæ³
www.youtube.com/watch,OCTOPATH TRAVELER	ğŸ®ã‚²ãƒ¼ãƒ å®Ÿæ³
www.youtube.com/watch,OWéƒ¨	ğŸ®Overwatch
www.youtube.com/watch,Octodad Dadliest Catch	ğŸ®ã‚²ãƒ¼ãƒ å®Ÿæ³
www.youtube.com/watch,Orwell	ğŸ®ã‚²ãƒ¼ãƒ å®Ÿæ³
www.youtube.com/watch,PEACH BALL,é–ƒä¹±ã‚«ã‚°ãƒ©	ğŸ®ã‚²ãƒ¼ãƒ å®Ÿæ³
www.youtube.com/watch,PLUGï¼†PLAY	ğŸ®PLUG&PLAY
www.youtube.com/watch,Planet Zoo	ğŸ®ã‚²ãƒ¼ãƒ å®Ÿæ³
www.youtube.com/watch,Remnant	ğŸ®ã‚²ãƒ¼ãƒ å®Ÿæ³
www.youtube.com/watch,Repressed	ğŸ®ã‚²ãƒ¼ãƒ å®Ÿæ³
www.youtube.com/watch,Roki 262,å¥å±‹	[ğŸŒˆå¥å±‹èŠ±é‚£]
www.youtube.com/watch,SURGEON SIMULATOR	ğŸ®ã‚²ãƒ¼ãƒ å®Ÿæ³
www.youtube.com/watch,Sayonara Wild Hearts	ğŸ®ã‚²ãƒ¼ãƒ å®Ÿæ³
www.youtube.com/watch,SpellBreak	ğŸ®ã‚²ãƒ¼ãƒ å®Ÿæ³
www.youtube.com/watch,Stone Story RPG	ğŸ®ã‚²ãƒ¼ãƒ å®Ÿæ³
www.youtube.com/watch,The Sexy Brutale	ğŸ®ã‚²ãƒ¼ãƒ å®Ÿæ³
www.youtube.com/watch,The Shapeshifting Detective	ğŸ®ã‚²ãƒ¼ãƒ å®Ÿæ³
www.youtube.com/watch,The Wake	ğŸ®ã‚²ãƒ¼ãƒ å®Ÿæ³
www.youtube.com/watch,The White Door	ğŸ®ã‚²ãƒ¼ãƒ å®Ÿæ³
www.youtube.com/watch,Typoman	ğŸ®ã‚²ãƒ¼ãƒ å®Ÿæ³
www.youtube.com/watch,WATCH DOGS	ğŸ®ã‚²ãƒ¼ãƒ å®Ÿæ³
www.youtube.com/watch,WILLï¼šç¾å¥½ä¸–ç•Œ	ğŸ®ã‚²ãƒ¼ãƒ å®Ÿæ³
www.youtube.com/watch,among us	[ğŸ®ã‚²ãƒ¼ãƒ å®Ÿæ³]
www.youtube.com/watch,ã€V4ã€‘	[ğŸ®ã‚²ãƒ¼ãƒ å®Ÿæ³]
www.youtube.com/watch,ã€ã«ã˜ã•ã‚“ã˜ã€‘åˆ‡ã‚ŠæŠœã-ã¯ã‚“ãºã‚“	âœ‚åˆ‡ã‚ŠæŠœãå‹•ç”»
www.youtube.com/watch,ã€ã«ã˜ã•ã‚“ã˜ã€‘åˆ‡ã‚ŠæŠœã-ã¯ã‚“ãºã‚“,ã‚¢ãƒ³ã‚¸ãƒ¥	ğŸŒˆã‚¢ãƒ³ã‚¸ãƒ¥ãƒ»ã‚«ãƒˆãƒªâ€¦
www.youtube.com/watch,ã€ã«ã˜ã•ã‚“ã˜ã€‘åˆ‡ã‚ŠæŠœã-ã¯ã‚“ãºã‚“,ãƒã‚¸ã‚­	ğŸŒˆæ¸‹è°·ãƒã‚¸ãƒ¡
www.youtube.com/watch,ã€ã«ã˜ã•ã‚“ã˜ã€‘åˆ‡ã‚ŠæŠœã-ã¯ã‚“ãºã‚“,ãƒ™ãƒ«ãƒ¢ãƒ³ãƒ‰	ğŸŒˆãƒ™ãƒ«ãƒ¢ãƒ³ãƒ‰ãƒ»ãƒãƒ³â€¦
www.youtube.com/watch,ã€ã«ã˜ã•ã‚“ã˜ã€‘åˆ‡ã‚ŠæŠœã-ã¯ã‚“ãºã‚“,ä¼è¦‹	ğŸŒˆä¼è¦‹ã‚¬ã‚¯
www.youtube.com/watch,ã€ã«ã˜ã•ã‚“ã˜ã€‘åˆ‡ã‚ŠæŠœã-ã¯ã‚“ãºã‚“,å†¥åºœ	ğŸŒˆğŸ‘¥ãƒ¡ã‚¤ãƒ•
www.youtube.com/watch,ã€ã«ã˜ã•ã‚“ã˜ã€‘åˆ‡ã‚ŠæŠœã-ã¯ã‚“ãºã‚“,çŸ³æ²¹ç‹	ğŸŒˆã‚¤ãƒ–ãƒ©ãƒ’ãƒ 
www.youtube.com/watch,ã€ã«ã˜ã•ã‚“ã˜ã€‘åˆ‡ã‚ŠæŠœã-ã¯ã‚“ãºã‚“,ç¬¹æœ¨	ğŸŒˆç¬¹æœ¨å’²
www.youtube.com/watch,ãˆã‚‹ã•ã‚“	[ğŸŒˆã‚¨ãƒ«ãƒ•ã®ãˆã‚‹]
www.youtube.com/watch,ãã†ã–ã‚“ã€åˆ‡ã‚ŠæŠœãã€‘,ã‚·ã‚§ãƒªãƒ³	[ğŸŒˆã‚·ã‚§ãƒªãƒ³ãƒ»ãƒãƒ¼ã‚¬â€¦]
www.youtube.com/watch,ã• ã•	[âœ‚åˆ‡ã‚ŠæŠœãå‹•ç”»]
www.youtube.com/watch,ã• ã•,ã‚¢ã‚´ãã‚“	[ğŸŒˆå‰£æŒåˆ€ä¹Ÿ]
www.youtube.com/watch,ã• ã•,ä¼è¦‹	[ğŸŒˆä¼è¦‹ã‚¬ã‚¯]
www.youtube.com/watch,ã• ã•,å‰£æŒ	[ğŸŒˆå‰£æŒåˆ€ä¹Ÿ]
www.youtube.com/watch,ã• ã•,å‰£æŒå®¶	[ğŸŒˆå‰£æŒåˆ€ä¹Ÿ]
www.youtube.com/watch,ã• ã•,æ¤å	[ğŸŒˆæ¤åå”¯è¯]
www.youtube.com/watch,ã—ã‚‡ã¼ã‚“ã®ã‚¢ã‚¯ã‚·ãƒ§ãƒ³	ğŸ®ã‚²ãƒ¼ãƒ å®Ÿæ³
www.youtube.com/watch,ã¤ã°ã,Yuyaã¡ã‚ƒã‚“	[ğŸŒˆğŸ‡°ğŸ‡· Shin Yuya]
www.youtube.com/watch,ã¤ã°ã,ãˆã‚‹	[ğŸŒˆã‚¨ãƒ«ãƒ•ã®ãˆã‚‹]
www.youtube.com/watch,ã¤ã°ã,ã¡ã²ã‚	[ğŸŒˆå‹‡æ°—ã¡ã²ã‚]
www.youtube.com/watch,ã¤ã°ã,ã¡ãƒ¼ãã‚“	[ğŸŒˆå‹‡æ°—ã¡ã²ã‚]
www.youtube.com/watch,ã¤ã°ã,ã‚¢ã‚­ãã‚“	[ğŸŒˆéˆ´è°·ã‚¢ã‚­]
www.youtube.com/watch,ã¤ã°ã,ã‚¢ãƒ³ã‚¸ãƒ¥	[ğŸŒˆã‚¢ãƒ³ã‚¸ãƒ¥ãƒ»ã‚«ãƒˆãƒªâ€¦]
www.youtube.com/watch,ã¤ã°ã,ã‚¨ãƒªãƒ¼	[ğŸŒˆã‚¨ãƒªãƒ¼ãƒ»ã‚³ãƒ‹ãƒ•ã‚¡ãƒ¼]
www.youtube.com/watch,ã¤ã°ã,ã‚«ãƒˆãƒªãƒ¼ãƒŠ	[ğŸŒˆã‚¢ãƒ³ã‚¸ãƒ¥ãƒ»ã‚«ãƒˆãƒªâ€¦]
www.youtube.com/watch,ã¤ã°ã,ã‚®ãƒãƒ©	[ğŸŒˆå¾¡ä¼½åŸæ±Ÿè‰¯]
www.youtube.com/watch,ã¤ã°ã,ãƒ•ãƒ¬ãƒ³	[ğŸŒˆãƒ•ãƒ¬ãƒ³ãƒ»ï¼¥ãƒ»ãƒ«ã‚¹â€¦]
www.youtube.com/watch,ã¤ã°ã,ãƒªã‚ªãƒ³æ§˜	[ğŸŒˆé·¹å®®ãƒªã‚ªãƒ³]
www.youtube.com/watch,ã¤ã°ã,æœ‰æ –ã¡ã‚ƒã‚“	[ğŸŒˆç‰©è¿°æœ‰æ –]
www.youtube.com/watch,ã¤ã°ã,æ¤å	[ğŸŒˆæ¤åå”¯è¯]
www.youtube.com/watch,ã¤ã°ã,ç«œèƒ†	[ğŸŒˆç«œèƒ†å°Š]
www.youtube.com/watch,ã¤ã°ã,è©©å­ãŠå§‰ã•ã‚“	[ğŸŒˆéˆ´é¹¿è©©å­]
www.youtube.com/watch,ã¤ã°ã,é åŒ—	[ğŸŒˆğŸ˜¥é åŒ—åƒå—]
www.youtube.com/watch,ã«ã˜ã‚¹ãƒ‘,ã‚¢ãƒ³ã‚¸ãƒ¥	[ğŸŒˆã‚¢ãƒ³ã‚¸ãƒ¥ãƒ»ã‚«ãƒˆãƒªâ€¦]
www.youtube.com/watch,ã«ã˜ã‚¹ãƒ‘,ãƒªã‚¼	[ğŸŒˆãƒªã‚¼ãƒ»ãƒ˜ãƒ«ã‚¨ã‚¹ã‚¿]
www.youtube.com/watch,ã«ã˜ã‚¹ãƒ‘,å¶	[ğŸŒˆå¶]
www.youtube.com/watch,ã¼ãã‚‰ã®ã‹ãã	ğŸ®ã‚²ãƒ¼ãƒ å®Ÿæ³
www.youtube.com/watch,ã‚Šãã„ã¡ãƒ•ã‚¡ãƒ¼ãƒ ã¾ã¨ã‚	[âœ‚åˆ‡ã‚ŠæŠœãå‹•ç”»]
www.youtube.com/watch,ã‚«ã‚ªã‚¹ã‚·ãƒ¼ã‚«ãƒ¼ç¬¹æœ¨	ğŸ®ã‚²ãƒ¼ãƒ å®Ÿæ³
www.youtube.com/watch,ã‚¬ãƒ©ãƒ¼ã‚¸ãƒ¥	ğŸ®ã‚²ãƒ¼ãƒ å®Ÿæ³
www.youtube.com/watch,ã‚¯ã‚¤ã‚ºã«ã˜ã‚ªãƒã‚¢	ğŸ®ã‚¯ã‚¤ã‚ºã«ã˜ã‚ªãƒã‚¢
www.youtube.com/watch,ã‚¯ãƒªãƒ¼ãƒãƒ£ãƒ¼ã¨æ‹ã—ã‚ˆã£ï¼ï¼ã“ã“ã®ãˆã“ã“ã‚ï¼	ğŸ®ã‚²ãƒ¼ãƒ å®Ÿæ³
www.youtube.com/watch,ã‚¶ãƒ»ãƒ«ãƒ¼ãƒ 	ğŸ®ã‚²ãƒ¼ãƒ å®Ÿæ³
www.youtube.com/watch,ãƒã‚¤ã‚ªãƒ¬ã‚¸ã‚¹ã‚¿ãƒ³ã‚¹	ğŸ®ã‚²ãƒ¼ãƒ å®Ÿæ³
www.youtube.com/watch,ãƒ•ã‚©ãƒ¼ã‚ªãƒŠãƒ¼	ğŸ®ã‚²ãƒ¼ãƒ å®Ÿæ³
www.youtube.com/watch,ãƒã‚±ãƒ¢ãƒ³ã‚·ãƒ¼ãƒ«ãƒ‰	ğŸ®ãƒã‚±ãƒƒãƒˆãƒ¢ãƒ³ã‚¹ã‚¿ãƒ¼
www.youtube.com/watch,ãƒã‚¤ãƒŠãƒ¼åˆ‡ã‚ŠæŠœãâ€•ã¬	[âœ‚åˆ‡ã‚ŠæŠœãå‹•ç”»]
www.youtube.com/watch,ãƒã‚¤ãƒŠãƒ¼åˆ‡ã‚ŠæŠœãâ€•ã¬,YuyaãŠã˜ã•ã‚“	[ğŸŒˆğŸ‡°ğŸ‡· Shin Yuya]
www.youtube.com/watch,ãƒã‚¤ãƒŠãƒ¼åˆ‡ã‚ŠæŠœãâ€•ã¬,æ¨‹å£å…ˆè¼©	[ğŸŒˆæ¨‹å£æ¥“]
www.youtube.com/watch,ãƒã‚¤ãƒŠãƒ¼åˆ‡ã‚ŠæŠœãâ€•ã¬,è½Ÿ	[ğŸŒˆè½Ÿäº¬å­]
www.youtube.com/watch,ãƒã‚¤ãƒŠãƒ¼åˆ‡ã‚ŠæŠœãâ€•ã¬,é™å²¡çš‡å¥³	[ğŸŒˆãƒªã‚¼ãƒ»ãƒ˜ãƒ«ã‚¨ã‚¹ã‚¿]
www.youtube.com/watch,ãƒ©ãƒˆãƒŠãƒ»ãƒ—ãƒ†ã‚£,ã‚ˆã‚‹ã¿ã‚“	ğŸŒˆå¤œè¦‹ã‚Œãª
www.youtube.com/watch,ãƒ©ãƒˆãƒŠãƒ»ãƒ—ãƒ†ã‚£,ã‚ã¼å­	â–¶ãƒ­ãƒœå­
www.youtube.com/watch,ãƒ©ãƒˆãƒŠãƒ»ãƒ—ãƒ†ã‚£,å¤©å®®	ğŸŒˆå¤©å®®ã“ã“ã‚
www.youtube.com/watch,ãƒ©ãƒˆãƒŠãƒ»ãƒ—ãƒ†ã‚£,è‘‰å±±ã¡ã‚ƒã‚“	[ğŸŒˆè‘‰å±±èˆéˆ´]
www.youtube.com/watch,ãƒ­ãƒ­ãƒ­ãƒ­	ğŸ®ã‚²ãƒ¼ãƒ å®Ÿæ³	ãƒœã‚«ãƒ­
www.youtube.com/watch,åƒ•ã¨å½¼å¥³ï¼ˆå¥³åŒ»ï¼‰ã®è¨ºå¯Ÿæ—¥èªŒ	ğŸ®ã‚²ãƒ¼ãƒ å®Ÿæ³
www.youtube.com/watch,åˆ¥è¡£è£…ãŠæŠ«éœ²ç›®	ğŸ”–æ–°è¡£è£…ãŠæŠ«éœ²ç›®
www.youtube.com/watch,å‹‡è€…ã®ãã›ã«ãªã¾ã„ãã ã€‚	ğŸ®ã‚²ãƒ¼ãƒ å®Ÿæ³
www.youtube.com/watch,å£°ç„¡The Graveyard	ğŸ®ã‚²ãƒ¼ãƒ å®Ÿæ³
www.youtube.com/watch,å¼±å°ã‚ªã‚»ãƒ­AI	ğŸ®ãƒœãƒ¼ãƒ‰ã‚²ãƒ¼ãƒ 
www.youtube.com/watch,ç±³å€‰ãƒ‡ãƒ¼ã‚¹,RRR	[ğŸŒˆã‚¸ãƒ§ãƒ¼ãƒ»åŠ›ä¸€]
www.youtube.com/watch,ç±³å€‰ãƒ‡ãƒ¼ã‚¹,RRR	[ğŸŒˆç«œèƒ†å°Š]
www.youtube.com/watch,ç±³å€‰ãƒ‡ãƒ¼ã‚¹,RRR	[ğŸŒˆé·¹å®®ãƒªã‚ªãƒ³]
www.youtube.com/watch,ç±³å€‰ãƒ‡ãƒ¼ã‚¹,RRR	[ğŸŒˆğŸ‘¥RRR]
www.youtube.com/watch,ç±³å€‰ãƒ‡ãƒ¼ã‚¹,ãˆã‚‹ã¡ã‚ƒã‚“	[ğŸŒˆã‚¨ãƒ«ãƒ•ã®ãˆã‚‹]
www.youtube.com/watch,ç±³å€‰ãƒ‡ãƒ¼ã‚¹,ãŠå¬¢æ§˜	[ğŸŒˆé·¹å®®ãƒªã‚ªãƒ³]
www.youtube.com/watch,ç±³å€‰ãƒ‡ãƒ¼ã‚¹,ã¡ãƒ¼	[ğŸŒˆå‹‡æ°—ã¡ã²ã‚]
www.youtube.com/watch,ç±³å€‰ãƒ‡ãƒ¼ã‚¹,ã¡ãƒ¼ã¡ã‚ƒã‚“	[ğŸŒˆå‹‡æ°—ã¡ã²ã‚]
www.youtube.com/watch,ç±³å€‰ãƒ‡ãƒ¼ã‚¹,ã¦ã‚™ã²ã‚™	[ğŸŒˆã§ã³ã§ã³ãƒ»ã§ã³ã‚‹]
www.youtube.com/watch,ç±³å€‰ãƒ‡ãƒ¼ã‚¹,ã¦ã‚™ã²ã‚™ã£ã¡	[ğŸŒˆã§ã³ã§ã³ãƒ»ã§ã³ã‚‹]
www.youtube.com/watch,ç±³å€‰ãƒ‡ãƒ¼ã‚¹,ã¦ã‚™ã‚	[ğŸŒˆæ¨‹å£æ¥“]
www.youtube.com/watch,ç±³å€‰ãƒ‡ãƒ¼ã‚¹,ã‚‚ãã‚™ã‚‚ãã‚™æ‚ªé­”	[ğŸŒˆã§ã³ã§ã³ãƒ»ã§ã³ã‚‹]
www.youtube.com/watch,ç±³å€‰ãƒ‡ãƒ¼ã‚¹,ã‚¢ã‚­ãã‚“	[ğŸŒˆéˆ´è°·ã‚¢ã‚­]
www.youtube.com/watch,ç±³å€‰ãƒ‡ãƒ¼ã‚¹,ã‚®ãƒãƒ©	[ğŸŒˆå¾¡ä¼½åŸæ±Ÿè‰¯]
www.youtube.com/watch,ç±³å€‰ãƒ‡ãƒ¼ã‚¹,ã‚¯ãƒ¬ã‚¢	[ğŸŒˆã‚·ã‚¹ã‚¿ãƒ¼ãƒ»ã‚¯ãƒ¬ã‚¢]
www.youtube.com/watch,ç±³å€‰ãƒ‡ãƒ¼ã‚¹,ãƒªã‚ªãƒ³	[ğŸŒˆé·¹å®®ãƒªã‚ªãƒ³]
www.youtube.com/watch,ç±³å€‰ãƒ‡ãƒ¼ã‚¹,ä¼è¦‹	[ğŸŒˆä¼è¦‹ã‚¬ã‚¯]
www.youtube.com/watch,ç±³å€‰ãƒ‡ãƒ¼ã‚¹,åˆ€ä¹ŸãŠå…„ã¡ã‚ƒã‚“	[ğŸŒˆå‰£æŒåˆ€ä¹Ÿ]
www.youtube.com/watch,ç±³å€‰ãƒ‡ãƒ¼ã‚¹,å‰£æŒ	[ğŸŒˆå‰£æŒåˆ€ä¹Ÿ]
www.youtube.com/watch,ç±³å€‰ãƒ‡ãƒ¼ã‚¹,å‹ãã‚“	[ğŸŒˆéˆ´æœ¨å‹]
www.youtube.com/watch,ç±³å€‰ãƒ‡ãƒ¼ã‚¹,åƒæ­³	[ğŸŒˆğŸ˜¥ä¹…é åƒæ­³]
www.youtube.com/watch,ç±³å€‰ãƒ‡ãƒ¼ã‚¹,å¤¢è¿½	[ğŸŒˆå¤¢è¿½ç¿”]
www.youtube.com/watch,ç±³å€‰ãƒ‡ãƒ¼ã‚¹,å§”å“¡é•·	[ğŸŒˆæœˆãƒç¾å…]
www.youtube.com/watch,ç±³å€‰ãƒ‡ãƒ¼ã‚¹,å°Šã•ã¾	[ğŸŒˆç«œèƒ†å°Š]
www.youtube.com/watch,ç±³å€‰ãƒ‡ãƒ¼ã‚¹,å¾¡æ›¹å¸	[ğŸŒˆå¯æœˆã‚³ã‚¦]
www.youtube.com/watch,ç±³å€‰ãƒ‡ãƒ¼ã‚¹,æã‚ã—ã„æ‚ªé­”	[ğŸŒˆã§ã³ã§ã³ãƒ»ã§ã³ã‚‹]
www.youtube.com/watch,ç±³å€‰ãƒ‡ãƒ¼ã‚¹,æ˜æ²»	[ğŸŒˆç«¥ç”°æ˜æ²»]
www.youtube.com/watch,ç±³å€‰ãƒ‡ãƒ¼ã‚¹,æ¥“	[ğŸŒˆæ¨‹å£æ¥“]
www.youtube.com/watch,ç±³å€‰ãƒ‡ãƒ¼ã‚¹,ç‹‚ äº• ã— ã¯ã‚™	[ğŸŒˆé»’äº•ã—ã°]
www.youtube.com/watch,ç±³å€‰ãƒ‡ãƒ¼ã‚¹,ç¬¹æœ¨	[ğŸŒˆç¬¹æœ¨å’²]
www.youtube.com/watch,ç±³å€‰ãƒ‡ãƒ¼ã‚¹,ç¾å…	[ğŸŒˆæœˆãƒç¾å…]
www.youtube.com/watch,ç±³å€‰ãƒ‡ãƒ¼ã‚¹,èŠ±ç•‘	[ğŸŒˆèŠ±ç•‘ãƒãƒ£ã‚¤ã‚«]
www.youtube.com/watch,ç±³å€‰ãƒ‡ãƒ¼ã‚¹,éƒ¡é“å…ˆç”Ÿ	[ğŸŒˆéƒ¡é“ç¾ç²]
www.youtube.com/watch,ç±³å€‰ãƒ‡ãƒ¼ã‚¹,é›‘ã‚³ã‚¦	[ğŸŒˆå¯æœˆã‚³ã‚¦]
www.youtube.com/watch,ç±³å€‰ãƒ‡ãƒ¼ã‚¹,é·¹ å®®	[ğŸŒˆé·¹å®®ãƒªã‚ªãƒ³]
www.youtube.com/watch,é¢¨é›…/ãµã†ãŒ	[âœ‚åˆ‡ã‚ŠæŠœãå‹•ç”»]
www.youtube.com/watch,é¸å¤œ,ã‚¢ãƒ«ã‚¹	[ğŸŒˆã‚¢ãƒ«ã‚¹ãƒ»ã‚¢ãƒ«ãƒãƒ«]
www.youtube.com/watch,é¸å¤œ,ã‚¨ã‚¯ã‚¹	[ğŸŒˆã‚¨ã‚¯ã‚¹ãƒ»ã‚¢ãƒ«ãƒ“ã‚ª]
www.youtube.com/watch,é»›ç°,ã‚¢ãƒ«ã‚¹	ğŸŒˆã‚¢ãƒ«ã‚¹ãƒ»ã‚¢ãƒ«ãƒãƒ«
www.youtube.com/watch,é»›ç°,ã‚¨ã‚¯ã‚¹	ğŸŒˆã‚¨ã‚¯ã‚¹ãƒ»ã‚¢ãƒ«ãƒ“ã‚ª
www.youtube.com/watch,é»›ç°,åŠ è³€ç¾ã•ã‚“	ğŸŒˆåŠ è³€ç¾ãƒãƒ¤ãƒˆ
www.youtube.com/watch,é»›ç°,æ„›åœ’ã•ã‚“	ğŸŒˆæ„›åœ’æ„›ç¾
www.youtube.com/watch,é»›ç°,æ˜é‚£	ğŸŒˆä¸‰ææ˜é‚£
www.youtube.com/watch,é»›ç°,ç¥ç”°	ğŸŒˆç¥ç”°ç¬‘ä¸€
www.youtube.com/watch,ï¼Observer_	ğŸ®ã‚²ãƒ¼ãƒ å®Ÿæ³
www.youtube.com/watch,ï¼§ï¼´ï¼¡5	ğŸ®GTA
ãŠã—ãƒã‚Šãƒ	ğŸŒˆæ¤åå”¯è¯
ãŠã—ãƒã‚Šãƒ	ğŸŒˆé­”ç•Œãƒã‚Šã‚Šã‚€
ãŠã—ãƒã‚Šãƒ	ğŸŒˆğŸ‘¥ãŠã—ãƒã‚Šãƒ
ã¦ã‚™ã²ã‚™ã£ã¡	[ğŸŒˆâœ ã§ã³ã£ã¡]
ã¿ã‹ãˆã‚‹	[ğŸŒˆã‚¨ãƒ«ãƒ•ã®ãˆã‚‹]
ã¿ã‹ãˆã‚‹	[ğŸŒˆæœˆãƒç¾å…]
ã¿ã‹ãˆã‚‹	[ğŸŒˆæ¨‹å£æ¥“]
ã¿ã‹ãˆã‚‹	[ğŸŒˆğŸ‘¥ã¿ã‹ãˆã‚‹]
ã‚€ãã‚™ã‚€ãã‚™[ğŸŒˆå®¶é•·ã‚€ã]
ã‚¨ãƒ’ã‚™ãƒãƒ«	[ğŸŒˆã‚¢ãƒ«ã‚¹ãƒ»ã‚¢ãƒ«ãƒãƒ«]
ã‚¨ãƒ’ã‚™ãƒãƒ«	[ğŸŒˆã‚¨ã‚¯ã‚¹ãƒ»ã‚¢ãƒ«ãƒ“ã‚ª]
ã‚¨ãƒ’ã‚™ãƒãƒ«	[ğŸŒˆğŸ‘¥ã‚¨ãƒ“ãƒãƒ«]
ã‚­ãƒ«ãƒªãƒ¼ãƒ€ãƒ¼	[ğŸŒˆãƒ©ãƒˆãƒŠãƒ»ãƒ—ãƒ†ã‚£]
ã‚­ãƒ«ãƒªãƒ¼ãƒ€ãƒ¼	[ğŸŒˆä¸‰ææ˜é‚£]
ã‚­ãƒ«ãƒªãƒ¼ãƒ€ãƒ¼	[ğŸŒˆå¶]
ã‚­ãƒ«ãƒªãƒ¼ãƒ€ãƒ¼	[ğŸŒˆæ¨‹å£æ¥“]
ã‚­ãƒ«ãƒªãƒ¼ãƒ€ãƒ¼	[ğŸŒˆğŸ‘¥ã‚­ãƒ«ãƒªãƒ¼ãƒ€ãƒ¼]
ã‚°ãƒªãƒ¼ãƒ³ãƒ«ãƒ¼ã‚¸ãƒ¥	ğŸŒˆã‚¸ãƒ§ãƒ¼ãƒ»åŠ›ä¸€
ã‚°ãƒªãƒ¼ãƒ³ãƒ«ãƒ¼ã‚¸ãƒ¥	ğŸŒˆèŠ±ç•‘ãƒãƒ£ã‚¤ã‚«
ã‚°ãƒªãƒ¼ãƒ³ãƒ«ãƒ¼ã‚¸ãƒ¥	ğŸŒˆğŸ‘¥ã‚°ãƒªãƒ¼ãƒ³ãƒ«ãƒ¼ã‚¸ãƒ¥
ãƒˆã‚™ãƒ¼ãƒ©	[ğŸŒˆãƒ‰ãƒ¼ãƒ©]
ãƒ˜ã‚™ãƒ«ãƒ¢ãƒ³ãƒˆã‚™ãƒã‚™ãƒ³ãƒ†ã‚™ãƒ©ã‚¹	[ğŸŒˆãƒ™ãƒ«ãƒ¢ãƒ³ãƒ‰ãƒ»ãƒãƒ³â€¦]
ä¼è¦‹ã‚«ã‚™ã‚¯	[ğŸŒˆä¼è¦‹ã‚¬ã‚¯]
å®¶é•·ã‚€ãã‚™	[ğŸŒˆå®¶é•·ã‚€ã]
ç´…ã®ãƒ©ã‚¤ãƒ˜ãƒ³ãƒãƒƒãƒ	ğŸŒˆã‚·ã‚§ãƒªãƒ³ãƒ»ãƒãƒ¼ã‚¬â€¦
ç´…ã®ãƒ©ã‚¤ãƒ˜ãƒ³ãƒãƒƒãƒ	ğŸŒˆãƒ«ã‚¤ã‚¹ãƒ»ã‚­ãƒ£ãƒŸãƒ¼
ç´…ã®ãƒ©ã‚¤ãƒ˜ãƒ³ãƒãƒƒãƒ	ğŸŒˆğŸ‘¥ç´…ã®ãƒ©ã‚¤ãƒ˜ãƒ³ãƒâ€¦
è¥¿åœ’ãƒã‚¯ã‚™ã‚µ	[ğŸŒˆè¥¿åœ’ãƒã‚°ã‚µ]
è§’ç„¡çµµé‡Œè¯	ğŸŒˆâœ è§’ç„¡çµµé‡Œè¯
è§’ç„¡çµµé‡Œè¯	ğŸŒˆãƒ¬ãƒ´ã‚£ãƒ»ã‚¨ãƒªãƒ•ã‚¡
é­”æ­¦å¤©	[ğŸŒˆã‚¢ãƒ«ã‚¹ãƒ»ã‚¢ãƒ«ãƒãƒ«]
é­”æ­¦å¤©	[ğŸŒˆã‚·ã‚§ãƒªãƒ³ãƒ»ãƒãƒ¼ã‚¬â€¦]
é­”æ­¦å¤©	[ğŸŒˆä¸ç ´æ¹Š]
é­”æ­¦å¤©	[ğŸŒˆåŠ è³€ç¾ãƒãƒ¤ãƒˆ]
é­”æ­¦å¤©	[ğŸŒˆå¤©å®®ã“ã“ã‚]
é­”æ­¦å¤©	[ğŸŒˆæœ¬é–“ã²ã¾ã‚ã‚Š]
é­”æ­¦å¤©	[ğŸŒˆç”²æ–ç”°æ™´]
é¹¿é³´é¤¨ã‚­ãƒªã‚³	[ğŸŒˆã‚¸ãƒ§ãƒ¼ãƒ»åŠ›ä¸€]
ëˆˆë³´ë¼	[ğŸŒˆğŸ‡°ğŸ‡· Bora Nun]
ï¼ƒã‘ã„ã‚ã„	[ğŸŒˆç›¸ç¾½ã†ã„ã¯]
ï¼ƒã‘ã„ã‚ã„	[ğŸŒˆé•·å°¾æ™¯]
ï¼ƒã‘ã„ã‚ã„	[ğŸŒˆğŸ‘¥ã‘ã„ã‚ã„]
www.youtube.com/watch,ï¼ƒãƒ¯ã‚¤ãƒªãƒ•5	[ğŸ®ã‚²ãƒ¼ãƒ å®Ÿæ³]
www.youtube.com/watch,æˆ¦æ…„è¿·å®®	[ğŸ®ã‚²ãƒ¼ãƒ å®Ÿæ³]
www.youtube.com/watch,ä¼èª¬ã®ã‚¹ã‚¿ãƒ•ã‚£ãƒ¼	[ğŸ®ã‚²ãƒ¼ãƒ å®Ÿæ³]
www.youtube.com/watch,VISAGE	[ğŸ®ãƒ›ãƒ©ã‚²å®Ÿæ³]
www.youtube.com/watch,Among us	[ğŸ®Among us]
www.youtube.com/watch,among us	[ğŸ®Among us]
ã‚‚ã¡ã‚‚ã¡ã‚³ãƒ©ãƒœ	[ğŸŒˆğŸ‘¥ã‚‚ã¡ã‚‚ã¡]
ã‚‚ã¡ã‚‚ã¡ã‚³ãƒ©ãƒœ	[ğŸŒˆå‰£æŒåˆ€ä¹Ÿ]
ã‚‚ã¡ã‚‚ã¡ã‚³ãƒ©ãƒœ	[ğŸŒˆæ¤åå”¯è¯]
www.youtube.com/watch,RPGãƒ„ã‚¯ãƒ¼ãƒ«	[ğŸ®RPGãƒ„ã‚¯ãƒ¼ãƒ«]
www.youtube.com/watch,beatmaniaIIDX ULTIMATE MOBILE	[ğŸ®éŸ³ã‚²ãƒ¼å®Ÿæ³]
www.youtube.com/watch,DEEMO	[ğŸ®éŸ³ã‚²ãƒ¼å®Ÿæ³]
www.youtube.com/watch,AIã¨åˆ‡ã‚ŠæŠœã,ã‚³ãƒã‚¯	[ğŸŒˆæ±å ‚ã‚³ãƒã‚¯]
www.youtube.com/watch,AIã¨åˆ‡ã‚ŠæŠœã,ãƒ’ã‚¹ã‚¤	[ğŸŒˆåŒ—å°è·¯ãƒ’ã‚¹ã‚¤]
www.youtube.com/watch,ç‰§å ´ç‰©èª	[ğŸ®ç‰§å ´ç‰©èª]
www.youtube.com/watch,Stela	[ğŸ®ã‚²ãƒ¼ãƒ å®Ÿæ³]
www.youtube.com/watch,ã¨ã‚‰ã¶ã‚‹ã§ã„ãš	[ğŸ®ã‚²ãƒ¼ãƒ å®Ÿæ³]
www.youtube.com/watch,VOEZ	[ğŸ®ã‚²ãƒ¼ãƒ å®Ÿæ³]
www.youtube.com/watch,Nunã•ã‚“	[ğŸŒˆğŸ‡°ğŸ‡· Bora Nun]
Apex #2434ãƒªãƒ¬ãƒ¼	[ğŸ”–APEXéƒ¨2434ã‚­ãƒ«ãƒªãƒ¬ãƒ¼]
www.youtube.com/watch,eng,aizono	[ğŸŒˆæ„›åœ’æ„›ç¾]
www.youtube.com/watch,eng,chaika	[ğŸŒˆèŠ±ç•‘ãƒãƒ£ã‚¤ã‚«]
www.youtube.com/watch,eng,emma	[ğŸŒˆãˆã¾â˜…ãŠã†ãŒã™ã¨]
www.youtube.com/watch,eng,gundou	[ğŸŒˆéƒ¡é“ç¾ç²]
www.youtube.com/watch,eng,gwelu	[ğŸŒˆã‚°ã‚¦ã‚§ãƒ«ãƒ»ã‚ªã‚¹ãƒ»â€¦]
www.youtube.com/watch,eng,hajime	[ğŸŒˆæ¸‹è°·ãƒã‚¸ãƒ¡]
www.youtube.com/watch,eng,harusaki	[ğŸŒˆæ˜¥å´ã‚¨ã‚¢ãƒ«]
www.youtube.com/watch,eng,kaida	[ğŸŒˆç”²æ–ç”°æ™´]
www.youtube.com/watch,eng,kanda	[ğŸŒˆç¥ç”°ç¬‘ä¸€]
www.youtube.com/watch,eng,kataribe	[ğŸŒˆèªéƒ¨ç´¡]
www.youtube.com/watch,eng,kingyozaka	[ğŸŒˆé‡‘é­šå‚ã‚ã„ã‚]
www.youtube.com/watch,eng,miyako	[ğŸŒˆç€¬æˆ¸ç¾å¤œå­]
www.youtube.com/watch,eng,sukoya	[ğŸŒˆå¥å±‹èŠ±é‚£]
www.youtube.com/watch,eng,tomoe	[ğŸŒˆç™½é›ªå·´]
www.youtube.com/watch,eng,yumeoi	[ğŸŒˆå¤¢è¿½ç¿”]
www.youtube.com/watch,eng,SakuYui	[ğŸŒˆğŸ‘¥ã•ãã‚†ã„]
www.youtube.com/watch,eng,SakuYui	[ğŸŒˆç¬¹æœ¨å’²]
www.youtube.com/watch,eng,SakuYui	[ğŸŒˆæ¤åå”¯è¯]
www.youtube.com/watch,Eng Sub	âœğŸ»è‹±èªå­—å¹•
www.youtube.com/watch,Eng sub	âœğŸ»è‹±èªå­—å¹•
www.youtube.com/watch,eng sub	âœğŸ»è‹±èªå­—å¹•
www.youtube.com/watch,Boraã¡ã‚ƒã‚“	[ğŸŒˆğŸ‡°ğŸ‡· Bora Nun]
www.youtube.com/watch,ã€ã«ã˜ã•ã‚“ã˜åˆ‡ã‚ŠæŠœãã€‘ã‚’æŠ•ç¨¿ã™ã‚‹äºº,å‰£æŒ	[ğŸŒˆå‰£æŒåˆ€ä¹Ÿ]
www.youtube.com/watch,ã€ã«ã˜ã•ã‚“ã˜åˆ‡ã‚ŠæŠœãã€‘ã‚’æŠ•ç¨¿ã™ã‚‹äºº,ã‚¢ãƒ³ã‚¸ãƒ¥	[ğŸŒˆã‚¢ãƒ³ã‚¸ãƒ¥ãƒ»ã‚«ãƒˆãƒªâ€¦]
www.youtube.com/watch,ã€ã«ã˜ã•ã‚“ã˜åˆ‡ã‚ŠæŠœãã€‘ã‚’æŠ•ç¨¿ã™ã‚‹äºº,ãƒªã‚¼	[ğŸŒˆãƒªã‚¼ãƒ»ãƒ˜ãƒ«ã‚¨ã‚¹ã‚¿]
ã‚¨ãƒ“ãƒãƒ¯ãƒ¼ãƒ«	[ğŸŒˆã‚¨ã‚¯ã‚¹ãƒ»ã‚¢ãƒ«ãƒ“ã‚ª]
ã‚¨ãƒ“ãƒãƒ¯ãƒ¼ãƒ«	[ğŸŒˆè‘›è‘‰]
ã‚¨ãƒ“ãƒãƒ¯ãƒ¼ãƒ«	[ğŸŒˆå¶]
ã‚¨ãƒ“ãƒãƒ¯ãƒ¼ãƒ«	[ğŸŒˆğŸ‘¥ã‚¨ãƒ“ãƒãƒ¯ãƒ¼ãƒ«]



