「あい	[AI]	固有名詞
「あいてぃあーきてくちゃ	[ITアーキテクチャ]	固有名詞
「あいてぃきょういく	[IT教育]	固有名詞
「あにめ	[アニメ]	固有名詞
「あぴ	[API]	固有名詞
「あまぞんぷらいむ	[🌐AmazonPrime]	固有名詞
「あまぷら	[🌐AmazonPrime]	固有名詞
「あろまてらぴー	[アロマテラピー]	固有名詞
「あーるぴーえー	[RPA]	固有名詞
「ぃふぇふぁｃｋ	[LifeHack]	固有名詞
「いちんふら」	[ITインフラ]	固有名詞
「いらすと	[イラスト]	固有名詞
「いんたーねっとろん	[インターネット論]	固有名詞
「いｔあーきてくちゃ	[ITアーキテクチャ]	固有名詞
「いｔきょういく	[IT教育]	固有名詞
「うぇぶ	[Web]	固有名詞
「うぇぶぎじゅつ	[Web技術]	固有名詞
「うぇぶさーびす	[Webサービス]	固有名詞
「うぇぶせいさく	[Web制作]	固有名詞
「うぇｂ	[Web]	固有名詞
「うぇｂぎじゅつ	[Web技術]	固有名詞
「うぇｂさーびす	[Webサービス]	固有名詞
「うぇｂでざいん	[Webデザイン]	固有名詞
「うたどうが	[歌動画]	固有名詞
「えいごがくしゅう	[英語学習]	固有名詞
「えいせいかんりしゃ	[衛生管理者]	固有名詞
「えむずーん	[股間戦士エムズーン]	固有名詞
「えむりーぐ	[Mリーグ]	固有名詞
「えーあい	[AI]	固有名詞
「えーあいろん	[AI論]	固有名詞
「えーぴーあい	[API]	固有名詞
「おかね	[💰お金]	固有名詞
「おっｓ	[OSS]	固有名詞
「おとそざい	[音素材]	固有名詞
「おーえすえす	[OSS]	固有名詞
「おーしーあーる	[OCR]	固有名詞
「おｃｒ	[OCR]	固有名詞
「かいはつ	[開発]	固有名詞
「かいはつしゅほう	[開発手法]	固有名詞
「かいはつりふぁれんす	[開発リファレンス]	固有名詞
「かいもの	[🛒買い物]	固有名詞
「かんぜんえいようしょく	[完全栄養食]	固有名詞
「がめ	[🎮ゲーム]	固有名詞
「きかいがくしゅう	[機会学習]	固有名詞
「きじ	[記事]	固有名詞
「きとうもひろ	[鬼頭莫宏]	固有名詞
「きょしつせいび	[居室整備]	固有名詞
「きりぬきどうが	[切り抜き動画]	固有名詞
「ぎょうむこうりつか	[業務効率化]	固有名詞
「くらうどぎじゅつ	[クラウド技術]	固有名詞
「くらうどそーしんぐ	[クラウドソーシング]	固有名詞
「ぐらふきゅーえる	[GraphQL]	固有名詞
「けんてい	[資格・検定]	固有名詞
「げーむ	[🎮ゲーム]	固有名詞
「こくさいけいざいほう	[国際経済法]	固有名詞
「こみけ	[コミケ]	固有名詞
「こらむ	[コラム]	固有名詞
「こんかつ	[婚活]	固有名詞
「しかくけんてい	[資格・検定]	固有名詞
「しかくしけん	[資格・検定]	固有名詞
「しごとじゅつ	[仕事術]	固有名詞
「しごとろん	[仕事論]	固有名詞
「しすてむかいはつ	[システム開発]	固有名詞
「しすてむせっけい	[システム設計]	固有名詞
「しぜんげんごしょり	[自然言語処理]	固有名詞
「しゃかいろん	[社会論]	固有名詞
「しょくひん	[食べもの・飲みもの]	固有名詞
「しょせき	[📓書籍]	固有名詞
「しょひょう	[書評]	固有名詞
「しんそうがくしゅう	[深層学習]	固有名詞
「しーでぃー	[💿CD]	固有名詞
「じゃばすくりぷと	[JavaScript]	固有名詞
「じゃゔぁｓｃりｐｔ	[JavaScript]	固有名詞
「じょうほうせきゅりてぃ	[情報セキュリティ]	固有名詞
「じょうほうせっけい	[情報設計]	固有名詞
「すぽーつ	[スポーツ]	固有名詞
「すまどら	[💊スマドラ]	固有名詞
「せいさんせいこうじょう	[生産性向上]	固有名詞
「そざい	[素材]	固有名詞
「そっき	[速記]	固有名詞
「そふとうぇあこうがく	[ソフトウェア工学]	固有名詞
「そふとうぇあてすと	[ソフトウェアテスト]	固有名詞
「たいぷすくりぷと	[TypeScript]	固有名詞
「たすくかんり	[タスク管理]	固有名詞
「たべもの	[食べもの・飲みもの]	固有名詞
「ちーむびるでぃんぐ	[チームビルディング]	固有名詞
「ついったー	[つぶやき]	固有名詞
「つぶやき	[つぶやき]	固有名詞
「てすとしゅほう	[テスト手法]	固有名詞
「でぃーえっくす	[DX]	固有名詞
「でざいん	[デザイン]	固有名詞
「でばいす	[デバイス]	固有名詞
「でんしさいん	[電子サイン]	固有名詞
「とぃってｒ	[つぶやき]	固有名詞
「とうけいでーた	[統計データ]	固有名詞
「とうこうまとめ	[投稿まとめ]	固有名詞
「にこにこどうが	[🌐ニコニコ動画]	固有名詞
「にゅーす	[📰ニュース]	固有名詞
「ねた	[🤣ネタ]	固有名詞
「のみもの	[食べもの・飲みもの]	固有名詞
「ばーじょんかんり	[バージョン管理]	固有名詞
「びじゅつ	[美術]	固有名詞
「ふぉんと	[フォント]	固有名詞
「ぶいちゅーばー	[VTuber]	固有名詞
「ぶろぐうんえい	[ブログ運営]	固有名詞
「ぶんかろん	[文化論]	固有名詞
「ぶんげい	[文芸]	固有名詞
「ぶんしょうじゅつ	[文章術]	固有名詞
「ぶんぼうぐ	[文房具]	固有名詞
「ぷれぜんじゅつ	[プレゼン術]	固有名詞
「ぷれぜんてーしょん	[プレゼン術]	固有名詞
「ぷろぐらみんぐ	[プログラミング]	固有名詞
「ぷろじぇくとかんり	[プロジェクト管理]	固有名詞
「へるすけあ	[ヘルスケア]	固有名詞
「ぺいんとそふと	[ペイントソフト]	固有名詞
「ぼき	[簿記]	固有名詞
「まいくろそふとおふぃす	[Microsoft Office]	固有名詞
「まとめ	[投稿まとめ]	固有名詞
「まんが	[📓漫画]	固有名詞
「まーけてぃんぐ	[マーケティング]	固有名詞
「まーじゃん	[🎮麻雀]	固有名詞
「みｃろそｆとっふぃせ	[Microsoft Office]	固有名詞
「もじおこし	[文字起こし]	固有名詞
「もじにゅうりょく	[文字入力]	固有名詞
「ゆーちゅーぶ	[🌐YouTube]	固有名詞
「ようつべ	[🌐YouTube]	固有名詞
「らいせんす	[ライセンス]	固有名詞
「らいとのべる	[📓ライトノベル]	固有名詞
「らいふはっく	[LifeHack]	固有名詞
「りもーとわーく	[リモートワーク]	固有名詞
「りーがるてっく	[LegalTech]	固有名詞
「れきし	[歴史]	固有名詞
「ゔぁぺ	[VAPE]	固有名詞
「ゔぇーぷ	[VAPE]	固有名詞
「ｃｄ	[💿CD]	固有名詞
「ｄｘ	[DX]	固有名詞
「ｈｒてｃｈ	[HrTech]	固有名詞
「ｐｈｐ	[PHP]	固有名詞
「ｒぱ	[RPA]	固有名詞
「ｖつべｒ	[VTuber]	固有名詞