「あいぞのまなみ	[愛園愛美]	固有名詞
「あいばういは	[相羽ういは]	固有名詞
「あかばねようこ	[赤羽葉子]	固有名詞
「あさひなあかね	[朝日南アカネ]	固有名詞
「あすかひな	[飛鳥ひな]	固有名詞
「あちきたちなみ	[遠北千南]	固有名詞
「あづちもも	[安土桃]	固有名詞
「あまみやこころ	[天宮こころ]	固有名詞
「あめもりさよ	[雨森小夜]	固有名詞
「あるすあるまる	[アルス・アルマル]	固有名詞
「あんじゅかとりーな	[アンジュ・カトリーナ]	固有名詞
「いえながむぎ	[家長むぎ]	固有名詞
「いずもかすみ	[出雲霞]	固有名詞
「いぬいとこ	[戌亥とこ]	固有名詞
「いぶらひむ	[イブラヒム]	固有名詞
「うしみいちご	[宇志海いちご]	固有名詞
「うづきこう	[卯月コウ]	固有名詞
「えくすあるびお	[エクス・アルビオ]	固有名詞
「えまおうがすと	[えま★おうがすと]	固有名詞
「えりーこにふぁー	[エリー・コニファー]	固有名詞
「える	[エルフのえる]	固有名詞
「えるふのえる	[エルフのえる]	固有名詞
「おとぎばらえら	[御伽原江良]	固有名詞
「おのまちはるか	[小野町春香]	固有名詞
「かいだはる	[甲斐田晴]	固有名詞
「かがみはやと	[加賀美ハヤト]	固有名詞
「かたりべつむぐ	[語部紡]	固有名詞
「かなえ	[叶]	固有名詞
「かんだしょういち	[神田笑一]	固有名詞
「きたこうじひすい	[北小路ヒスイ]	固有名詞
「きんぎょざかめいろ	[金魚坂めいろ]	固有名詞
「ぎるざれんさんせい	[ギルザレンⅢ世]	固有名詞
「くずは	[葛葉]	固有名詞
「くどうちとせ	[久遠千歳]	固有名詞
「くるすなつめ	[来栖夏芽]	固有名詞
「くろいしば	[黒井しば]	固有名詞
「ぐうぇるおすがーる	[グウェル・オス・ガ…]	固有名詞
「ぐんどうみれい	[郡道美玲]	固有名詞
「けんもちとうや	[剣持刀也]	固有名詞
「げんづきとうじろう	[弦月藤士郎]	固有名詞
「さえぐさあきな	[三枝明那]	固有名詞
「さくらりつき	[桜凛月]	固有名詞
「ささきさく	[笹木咲]	固有名詞
「しいなゆいか	[椎名唯華]	固有名詞
「しぇりんばーがんでぃ	[シェリン・バーガン…]	固有名詞
「しすたーくれあ	[シスター・クレア]	固有名詞
「しずかりん	[静凛]	固有名詞
「しぶやはじめ	[渋谷ハジメ]	固有名詞
「しらゆきともえ	[白雪巴]	固有名詞
「じょーりきいち	[ジョー・力一]	固有名詞
「すおうさんご	[周央サンゴ]	固有名詞
「すこやかな	[健屋花那]	固有名詞
「すずかうたこ	[鈴鹿詩子]	固有名詞
「すずきまさる	[鈴木勝]	固有名詞
「すずはらるる	[鈴原るる]	固有名詞
「すずやあき	[鈴谷アキ]	固有名詞
「せつな	[雪汝]	固有名詞
「せとみやこ	[瀬戸美夜子]	固有名詞
「たかみやりおん	[鷹宮リオン]	固有名詞
「つきのみと	[月ノ美兎]	固有名詞
「つきみしずく	[月見しずく]	固有名詞
「でびでびでびる	[でびでび・でびる]	固有名詞
「とうどうこはく	[東堂コハク]	固有名詞
「とどろききょうこ	[轟京子]	固有名詞
「どーら	[ドーラ]	固有名詞
「なかおあずま	[名伽尾アズマ]	固有名詞
「ながおけい	[長尾景]	固有名詞
「ならか	[奈羅花]	固有名詞
「なるせなる	[成瀬鳴]	固有名詞
「なるとこがね	[鳴門こがね]	固有名詞
「にしぞのちぐさ	[西園チグサ]	固有名詞
「にじさんじ	[にじさんじ]	固有名詞
「にゅいそしえーる	[ニュイ・ソシエール]	固有名詞
「はかせふゆき	[葉加瀬冬雪]	固有名詞
「はっさくゆず	[八朔ゆず]	固有名詞
「はなばたけちゃいか	[花畑チャイカ]	固有名詞
「はやせそう	[早瀬走]	固有名詞
「はやままりん	[葉山舞鈴]	固有名詞
「はるさきえある	[春崎エアル]	固有名詞
「ひぐちかえで	[樋口楓]	固有名詞
「ふしみがく	[伏見ガク]	固有名詞
「ふみ	[フミ]	固有名詞
「ふみのたまき	[文野環]	固有名詞
「ふれんいーるすたりお	[フレン・E・ルスタリオ]	固有名詞
「ふわみなと	[不破湊]	固有名詞
「べるもんどばんでらす	[ベルモンド・バンデ…]	固有名詞
「ほしかわさら	[星川サラ]	固有名詞
「そらぼしきらめ	[星空きらめ]	固有名詞
「ほんまひまわり	[本間ひまわり]	固有名詞
「まいもとけいすけ	[舞元啓介]	固有名詞
「まかいのりりむ	[魔界ノりりむ]	固有名詞
「ましろ	[ましろ]	固有名詞
「まちたちま	[町田ちま]	固有名詞
「まつかいまお	[魔使マオ]	固有名詞
「まゆずみかい	[黛灰]	固有名詞
「めりっさきんれんか	[メリッサ・キンレンカ]	固有名詞
「もいら	[モイラ]	固有名詞
「もののべありす	[物述有栖]	固有名詞
「もりなかかざき	[森中花咲]	固有名詞
「やぐるまりね	[矢車りね]	固有名詞
「やしゃのかみ	[海夜叉神]	固有名詞
「やしろきずく	[社築]	固有名詞
「やまがみかるた	[山神カルタ]	固有名詞
「やみよのもるる	[闇夜乃モルル]	固有名詞
「ゆうきちひろ	[勇気ちひろ]	固有名詞
「ゆうひりり	[夕陽リリ]	固有名詞
「ゆきしろましろ	[雪城眞尋]	固有名詞
「ゆづきろあ	[夢月ロア]	固有名詞
「ゆめおいかける	[夢追翔]	固有名詞
「ゆやしん	[Yuya Shin]	固有名詞
「ゆーどりっく	[ユードリック]	固有名詞
「よるみれな	[夜見れな]	固有名詞
「らとなぷてぃ	[ラトナ・プティ]	固有名詞
「りぜへるえすた	[リゼ・ヘルエスタ]	固有名詞
「りゅーしぇん	[緑仙]	固有名詞
「りんどうみこと	[竜胆尊]	固有名詞
「るいすきゃみー	[ルイス・キャミー]	固有名詞
「れゔぃえりふぁ	[レヴィ・エリファ]	固有名詞
「わらべだめいじー	[童田明治]	固有名詞
「れいんどろっぷす	[🎤Rain Drops]	固有名詞
「あおみかやな	[蒼海カヤナ]	固有名詞
「あさぎりいづる	[朝霧いづる]	固有名詞
「いちのもりこひな	[苺ノ森こひな]	固有名詞
「かたくらひとみ	[片倉一実]	固有名詞
「くれまはくぼ	[暮間珀暮]	固有名詞
「くれやぺい	[紅夜ぺい]	固有名詞
「こはなてくと	[小花てくと]	固有名詞
「ころぼしまう	[ころぼしまう]	固有名詞
「しのみやとうか	[四ノ宮透華]	固有名詞
「はえとりかづら	[蝿取かづら]	固有名詞
「はとおかここ	[鳩岡小恋]	固有名詞
「ひじりぐれいる	[聖グレイル]	固有名詞
「ひめるち	[雛芽るち]	固有名詞
「ふでそめしき	[筆染四季]	固有名詞
「ほうしょうてあ	[宝生てあ]	固有名詞
「みかげみゆ	[観影みゆ]	固有名詞
「みさごゆきまち	[雎雪待]	固有名詞
「みなみあやね	[南絢音]	固有名詞
「みーてぃあ	[ミーティア]	固有名詞
「ゆめのぐらふぃあ	[ユメノグラフィア]	固有名詞
「りいか	[りいか]	固有名詞
「りくどうかろ	[六道カロ]	固有名詞
「ろっどくろうりー	[ロッド・クロウリー]	固有名詞
「ぶいちゅーばー	[VTuber]	固有名詞
「ｖつべｒ	[VTuber]	固有名詞
「あまつかりりえる	[天使リリエル]	固有名詞
「いなばはねる	[因幡はねる]	固有名詞
「いぬやまたまき	[犬山たまき]	固有名詞
「いまさかはくの	[今酒ハクノ]	固有名詞
「うたいめいか	[歌衣メイカ]	固有名詞
「かもがみにゅう	[鴨神にゅう]	固有名詞
「きずなあい	[キズナアイ]	固有名詞
「きまぐれくっく	[きまぐれクック]	固有名詞
「くいずのっく	[QuizKnock]	固有名詞
「くすのきしお	[楠栞桜]	固有名詞
「こかんせんしえむずーん	[股間戦士エムズーン]	固有名詞
「さきのもこ	[咲乃もこ]	固有名詞
「ざき	[ザキ]	固有名詞
「すずきけんぞう	[鈴木けんぞう]	固有名詞
「せんばくろの	[千羽黒乃]	固有名詞
「てんかいつかさ	[天開司]	固有名詞
「ほろらいぶ	[ホロライブ]	固有名詞
「まーじゃんけいさつひろー	[麻雀警察ひろー]	固有名詞
「みなとあくあ	[湊あくあ]	固有名詞
「もこう	[もこう]	固有名詞
「あおいゆう	[蒼井優]	固有名詞
「あさくらこうしん	[🀄朝倉康心]	固有名詞
「うえはらあずみ	[🎤上原あずみ]	固有名詞
「うる	[🎤Uru]	固有名詞
「がーねっとくろう	[🎤GARNET CROW]	固有名詞
「こまつみほ	[🎤小松未歩]	固有名詞
「さいとうごう	[🀄齋藤豪]	固有名詞
「つぼみ	[つぼみ]	固有名詞
「とさかじゅん	[登坂淳]	固有名詞
「ひらさわげんき	[🀄平澤元気]	固有名詞
「やまざとりょうた	[山里亮太]	固有名詞
「りずむ	[🎤Rythem]	固有名詞
「みうらかずよし	[三浦知良]	固有名詞
「いとうらいふ	[伊東ライフ]	固有名詞
「うえしばりいち	[植芝理一]	固有名詞
「うめさおただお	[梅棹忠夫]	固有名詞
「えのもとなりこ	[榎本ナリコ]	固有名詞
「きとうもひろ	[鬼頭莫宏]	固有名詞
「なかはらちゅうや	[中原中也]	固有名詞
「ふんぼ	[ふんぼ]	固有名詞
「あくせるわーるど	[📽アクセル・ワールド]	固有名詞
「いせかいしょくどう	[📽異世界食堂]	固有名詞
「えすぱーまみ	[📽エスパー魔美]	固有名詞
「がっこうぐらし	[📽がっこうぐらし！]	固有名詞
「がて	[📽GATE]	固有名詞
「けむりくさ	[📽ケムリクサ]	固有名詞
「げーと	[📽GATE]	固有名詞
「このすばらしいせかいにしゅくふくを	[📽この素晴らしい世…]	固有名詞
「こばやしさんちのめいどらごん	[📽小林さんちのメイ…]	固有名詞
「しんせかいより	[📽新世界より]	固有名詞
「じょうかまちのだんでらいおん	[📽城下町のダンデラ…]	固有名詞
「すずみやはるひのゆううつ	[📽涼宮ハルヒの憂鬱]	固有名詞
「ぜつえんのてんぺすと	[📽絶園のテンペスト]	固有名詞
「そーどあーとおんらいん	[📽ソードアート・オ…]	固有名詞
「たてのゆうしゃのなりあがり	[📽盾の勇者の成り上…]	固有名詞
「てんせいしたらすらいむだったけん	[📽転生したらスライ…]	固有名詞
「でみちゃんはかたりたい	[📽亜人ちゃんは語り…]	固有名詞
「へゔぃーおぶじぇくと	[📽ヘヴィーオブジェ…]	固有名詞
「ほおづきのれいてつ	[📽鬼灯の冷徹]	固有名詞
「ぼくらの	[📽ぼくらの]	固有名詞
「まほうしょうじょいくせいけいかく	[📽魔法少女育成計画]	固有名詞
「めいどいんあびす	[📽メイドインアビス]	固有名詞
「もーれつぱいれーつ	[📽モーレツ宇宙海賊]	固有名詞
「ようじょせんき	[📽幼女戦記]	固有名詞
「らくだいきしのきゃばるりぃ	[📽落第騎士の英雄譚]	固有名詞
「りぜろからはじめるいせかいせいかつ	[📽Re：ゼロから始め…]	固有名詞
「ろぐほらいずん	[📽ログ・ホライズン]	固有名詞
「ろっかのゆうしゃ	[📽六花の勇者]	固有名詞
「ろみおのあおいそら	[📽ロミオの青い空]	固有名詞
「あぺｘ	[🎮Apex Legends]	固有名詞
「えいぺっくす	[🎮Apex Legends]	固有名詞
「あーく	[🎮Ark]	固有名詞
「えいぺっくす	[🎮Apex Legends]	固有名詞
「かんこれ	[🎮艦これ]	固有名詞
「くらふとぴあ	[🎮Craftopia]	固有名詞
「じゃんたま	[🎮雀魂]	固有名詞
「せかいじゅのめいきゅう	[🎮世界樹の迷宮]	固有名詞
「てんほう	[🎮天鳳]	固有名詞
「ふぉーるがいず	[🎮Fall Guys]	固有名詞
「ぽけっともんすたー	[🎮ポケットモンスター]	固有名詞
「まーじゃん	[🎮麻雀]	固有名詞
「かーどげーむ	[🎮カードゲーム]	固有名詞
「がめ	[🎮ゲーム]	固有名詞
「げーむ	[🎮ゲーム]	固有名詞
「にこにこどうが	[🌐ニコニコ動画]	固有名詞
「こんてなものがたり	[📚コンテナ物語]	固有名詞
「ちてきせいさんのぎじゅつ	[📚知的生産の技術]	固有名詞
「きぎょう	[🏙企業]	固有名詞
「いちからかぶしきがいしゃ	[いちから株式会社]	固有名詞
「かばーかぶしきがいしゃ	[カバー株式会社]	固有名詞
「あまぞんぷらいむ	[🌐AmazonPrime]	固有名詞
「あまぷら	[🌐AmazonPrime]	固有名詞
「ゆーちゅーぶ	[🌐YouTube]	固有名詞
「ようつべ	[🌐YouTube]	固有名詞
「ゆうつべ	[🌐YouTube]	固有名詞
「ついったー	[🌐Twitter]	固有名詞
「しょせきのでんしか	[🔖書籍の電子化]	固有名詞
「いーしーそうどう	[🔖ec騒動]	固有名詞
「えｃそうどう	[🔖ec騒動]	固有名詞
「いのちのかがやき	[🔖いのちの輝き]	固有名詞
「ふりーじあたいきゅう	[🔖フリージア耐久]	固有名詞
「きょうあにほうかさつじんじけん	[🔖京都アニ放火殺人…]	固有名詞
「きょうとあにめーしょん	[🔖京都アニ放火殺人…]	固有名詞
「ちてきせいさんのぎじゅつ	[🔖知的生産の技術]	固有名詞
「かいてきにいえですごす	[🔖快適に家で過ごす]	固有名詞
「にじさんじひゃっきやこう	[🔖にじさんじ百鬼夜行]	固有名詞
：あいばういは	🍮💎	固有名詞
：あかばねようこ	💀	固有名詞
：あさひなあかね	🦖🎖	固有名詞
：あすかひな	🐤	固有名詞
：あちきたちなみ	🍬	固有名詞
：あづちもも	🍑	固有名詞
：いえながむぎ	🌷	固有名詞
：いずもかすみ	🦑	固有名詞
：いぶらひむ	💧	固有名詞
：うしみいちご	🍓	固有名詞
：えくすあるびお	🦐	固有名詞
：えまおうがすと	★	固有名詞
：えりーこにふぁー	🌲	固有名詞
：える	🗼	固有名詞
：おとぎばらえら	🏰🕛	固有名詞
：おのまちはるか	♨️	固有名詞
：かいだはる	🌞	固有名詞
：かがみはやと	🏢	固有名詞
：かなえ	🔫	固有名詞
：かんだしょういち	🔪🍅	固有名詞
：きたこうじひすい	❇	固有名詞
：ぎるざれんさんせい	🏰🌕	固有名詞
：きんぎょざかめいろ	🩰	固有名詞
：ぐうぇるおすがーる	😎	固有名詞
：くるすなつめ	🐏🎵	固有名詞
：くろいしば	🐕🐾	固有名詞
：げんづきどうじろう	🎻🛵	固有名詞
：さえぐさあきな	🌶	固有名詞
：さくらりつき	🌸	固有名詞
：ささきさく	🎋	固有名詞
：しいなゆいか	👻	固有名詞
：しぇりんばーがんでぃ	🧐	固有名詞
：しずかりん	💜	固有名詞
：しずかりん	🥦	固有名詞
：しすたーくれあ	🔔	固有名詞
：しぶやはじめ	🌱	固有名詞
：じょーりきいち	🤡	固有名詞
：しらゆきともえ	👠⛓	固有名詞
：すおうさんご	💞🦩	固有名詞
：すこやかな	💉💘	固有名詞
：すずかうたこ	🎶	固有名詞
：すずきまさる	☪	固有名詞
：すずはらるる	🎨	固有名詞
：すずやあき	🐈	固有名詞
：せつな	❄️	固有名詞
：せとみやこ	📷💚	固有名詞
：そらぼしきらめ	🌌	固有名詞
：たかみやりおん	🦅	固有名詞
：つきのみと	🐰	固有名詞
：つきみしずく	🎑💊	固有名詞
：でびでびでびる	🚪👿	固有名詞
：とうどうこはく	🍯	固有名詞
：どーら	🔥	固有名詞
：とどろききょうこ	🐐	固有名詞
：なかおあずま	☀️	固有名詞
：ながおけい	☯	固有名詞
：ならか	✖🍳	固有名詞
：にしぞのちぐさ	🐬🌱	固有名詞
：にゅいそしえーる	🎃	固有名詞
：はかせふゆき	⚗	固有名詞
：はっさくゆず	🍊	固有名詞
：はなばたけちゃいか	🌵	固有名詞
：はやせそう	🚴‍♀️	固有名詞
：はやせそう	🏃‍♀️💨	固有名詞
：はやままりん	🍃🗻	固有名詞
：はるさきえある	🍭	固有名詞
：ひぐちかえで	🍁	固有名詞
：ふしみがく	🦊	固有名詞
：ふみ	🔖	固有名詞
：ふみのたまき	🐟	固有名詞
：ふれんいーるすたりお	🎠	固有名詞
：ふわみなと	🥂✨	固有名詞
：べるもんどばんでらす	🥃	固有名詞
：ほしかわさら	🌟	固有名詞
：ほんまひまわり	🌻	固有名詞
：まいもとけいすけ	👨‍🌾	固有名詞
：まかいのりりむ	🍼	固有名詞
：ましろ	🧷	固有名詞
：まつかいまお	💥	固有名詞
：まゆずみかい	💻💙	固有名詞
：めりっさきんれんか	🐝	固有名詞
：もののべありす	♥️♠️♦️♣️	固有名詞
：もりなかかざき	🐻	固有名詞
：もりなかかざき	🌼	固有名詞
：やぐるまりね	🌽	固有名詞
：やしろきずく	🖥	固有名詞
：やまがみかるた	🎴	固有名詞
：やみよのもるる	🍜	固有名詞
：ゆうきちひろ	🎀💙	固有名詞
：ゆうひりり	🌇	固有名詞
：ゆきしろまひろ	🌐💫	固有名詞
：ゆづきろあ	🌖	固有名詞
：ゆめおいかける	🎤	固有名詞
：よるみれな	🎩🐤	固有名詞
：らとなぷてぃ	🐻💎	固有名詞
：りぜへるえすた	👑	固有名詞
：りゅーしぇん	🐼	固有名詞
：りんどうみこと	🍶⚜️	固有名詞
：るいすきゃみー	❤️🦋	固有名詞
：れゔぃえりふぁ	🔲	固有名詞
：わらべだめいじー	🐺🍎	固有名詞

