こんばんわにのこ	こんばんワニノコ	独立語	月ノ美兎 始まりの挨拶
こんれーなー	こんれ～な～	独立語	夜見れな 始まりの挨拶
おつかれーなー	おつかれ～な～	独立語	夜見れな 終わりの挨拶
こんにちふぁ	こんにちファ	独立語	レヴィ・エリファ 始まりの挨拶
らいふさんきょうだい	ライフ三兄弟	固有名詞	グウェル・オス・ガール、瀬戸美夜子、愛園愛美
ながおけい	長尾景	人名
げんづきとうじろう	弦月藤士郎	人名
かいだはる	甲斐田晴	人名
おうまこうこく	桜魔皇国	固有名詞
そらほしきらめ	空星きらめ	人名
きんぎょざかめいろ	金魚坂めいろ	人名
たずみりく	田角陸	人名
たずみりく	田角リク	人名

!  世怜音女学院 関連
あさひなあかね	朝日南アカネ	人名
にしぞのちぐさ	西園チグサ	人名
すおうさんご	周央サンゴ	人名
とうどうこはく	東堂コハク	人名
きたこうじひすい	北小路ヒスイ	人名
せれいねじょがくいん	世怜音女学院	固有名詞
せれいねえんげきどうこうかい	世怜音演劇同好会	固有名詞	朝日南アカネ、北小路ヒスイ、周央サンゴ、東堂コハク、西園チグサ
すおう	周央	姓
あーことひすぴ	あーことひすぴ	固有名詞	朝日南アカネ、北小路ヒスイ
あーこはっく	アーコハック	固有名詞	朝日南アカネ、東堂コハク
あかんご	アカンゴ	固有名詞	朝日南アカネ、周央サンゴ
あかんごちぐ	あかんごちぐ	固有名詞	朝日南アカネ、周央サンゴ、西園チグサ
きもんず	鬼門ズ	固有名詞	北小路ヒスイ、東堂コハク
じぇいどりうむ	ジェイドリウム	固有名詞	北小路ヒスイ、西園チグサ
おうとう	おうとう	固有名詞	周央サンゴ、東堂コハク
ばくぽんちー	ばくぽんち～	独立語	朝日南アカネ 始まりの挨拶
おまちかね	お待ちカネ	独立語	朝日南あかね 待機の挨拶
んご	ンゴ	終助詞	周央サンゴ 語尾

! ▽▲TRiNITY▲▽ 関連
とりにてぃー	▽▲TRiNITY▲▽	固有名詞	鷹宮リオン、葉加瀬冬雪、フレン・E・ルスタリオ
えるふぁんふぁーれ	L♡ファンファーレ	固有名詞	▽▲TRiNITY▲▽オリジナル曲
れん	Ren	固有名詞	フレン・E・ルスタリオ？
ふゆ	Fuyu	固有名詞	葉加瀬冬雪？
りお	Rio	固有名詞	鷹宮リオン？
ふれんいーるすたりお	Ren	固有名詞	▽▲TRiNITY▲▽
たかみやりおん	Rio	固有名詞	▽▲TRiNITY▲▽
はかせふゆき	Fuyu	固有名詞	▽▲TRiNITY▲▽

ゆめのぐらふぃあ	ユメノグラフィア	固有名詞
かたくらひとみ	片倉一実	人名
ひとみ	一実	名
みなみあやね	南絢音	人名
あやね	絢音	名
ひじりぐれいる	聖グレイル	人名
ぐれいる	グレイル	名
ほうしょうてあ	宝生てあ	人名
てあ	てあ	名
りくどうかろ	六道カロ	人名
りくどう	六道	姓
かろ	カロ	名
はとおかここ	鳩岡小恋	人名
はとおか	鳩岡	姓
ここ	小恋	名
ころぼしまう	ころぼしまう	人名
ころぼし	ころぼし	姓
まう	まう	名
みかげみゆ	観影みゆ	人名
みかげ	観影	姓
ふでそめしき	筆染四季	人名
ふでそめ	筆染	姓
しき	四季	名
みさごゆきまち	雎雪待	人名
みさご	雎	姓
ゆきまち	雪待	名
いちのもりこひな	苺ノ森こひな	人名
いちのもり	苺ノ森	姓
こひな	こひな	名
こはなてくと	小花てくと	人名
こはな	小花	姓
てくと	てくと	名
りいか	りいか	人名
りいか	りいか	名
しのみやとうか	四ノ宮透華	人名
とうか	透華	名
ろっどくろうりー	ロッド・クロウリー	人名
くれやぺい	紅夜ぺい	人名
くれや	紅夜	姓
ぺい	ぺい	名
はえとりかづら	蝿取かづら	人名
はえとり	蝿取	姓
かずら	かずら	名
みーてぃあ	ミーティア	人名
みーてぃあ	ミーティア	名
あさぎりいづる	朝霧いづる	人名
あさぎり	朝霧	姓
いづる	いづる	名
くれまはくぼ	暮間珀暮	人名
くれま	暮間	姓
はくぼ	珀暮	名
あおみかやな	蒼海カヤナ	人名
あおみ	蒼海	姓
かやな	カヤナ	名
ひめるち	雛芽るち	人名
ひめ	雛芽	姓
るち	るち	名

