「うたどうが	[歌動画]	固有名詞
「かいもの	[買い物]	固有名詞
「きとうもひろ	[鬼頭莫宏]	固有名詞
「きょしつせいび	[居室整備]	固有名詞
「きりぬきどうが	[切り抜き動画]	固有名詞
「しょくりょう	[食料]	固有名詞
「じゃんたま	[雀魂]	固有名詞
「ついったー	[つぶやき]	固有名詞
「つぶやき	[つぶやき]	固有名詞
「とぃってｒ	[つぶやき]	固有名詞
「とうこうまとめ	[投稿まとめ]	固有名詞
「にゅーす	[ニュース]	固有名詞
「へるすけあ	[ヘルスケア]	固有名詞
「まとめ	[投稿まとめ]	固有名詞
「ゆーちゅーぶ	[YouTube]	固有名詞
「ようつべ	[YouTube]	固有名詞
「ｖつべｒ	[VTuber]	固有名詞
「ぶいちゅーばー	[VTuber]	固有名詞
「しょせき	[書籍]	固有名詞
「めでぃあ	[メディア]	固有名詞
「きじ	[記事]	固有名詞
「ゔぁぺ	[VAPE]	固有名詞
「こらむ	[コラム]	固有名詞
