かもがみ	鴨神	姓
かもがみにゅう	鴨神にゅう	人名
きとう	鬼頭	性
きとうもひろ	鬼頭莫宏	人名
くすのきしお	楠栞桜	人名
くろの	黒乃	名
こまつみほ	小松未歩	人名
さきの	咲乃	姓
さきのもこ	咲乃もこ	人名
しお	栞桜	名
じゃんたま	雀魂	固有名詞
せんば	千羽	性
せんばくろの	千羽黒乃	人名
てんかい	性
てんかいつかさ	天開司	人名
でみちゃんはかたりたい	亜人ちゃんは語りたい	固有名詞
みほ	未歩	名
もひろ	莫宏	名
りぜろからはじめるいせかいせいかつ	Re:ゼロから始める異世界生活	固有名詞
うえしばりいち	植芝理一	人名
こんてん	魂天	固有名詞
じゃんけつ	雀傑	固有名詞
いなばはねる	因幡はねる	人名
いなば	因幡	性
はねる	はねる	名
こかんせんし	股間戦士	姓
ぜつえんのてんぺすと	絶園のテンペスト	固有名詞
ぜつえん	絶園	名詞
